저기::あそこ あそこ
거짓말::うそ
학교::学校 がっこう
오늘::今日 きょう
이것::これ
사전::辞書 じしょ
그::その
그것::それ
일요일::日曜日 にちようび
일본인, 일본 사람::日本人 にほんじん
사람::人 ひと
누나, 언니(높이지 않는 호칭)::姉 あね
연필::鉛筆 えんぴつ
학생(대학생)::学生 がくせい
한국인, 한국 사람::韓国人 かんこくじん
교실::教室 きょうしつ
은행::銀行 ぎんこう
거기::そこ
대학생::大学生 だいがくせい
볼펜::ボールペン
나(남자)::僕 ぼく
저, 나(반말 구어에서는 여자)::私 わたし
아침밥::朝ごはん あさごはん
오빠, 형(높이지 않는 호칭)::兄 あに
회사원::会社員 かいしゃいん
어제::昨日 きのう
경찰관::警官 けいかん
샌드위치::サンドイッチ
사장(님)::社長 しゃちょう
숙제::宿題 しゅくだい
생일::誕生日 たんじょうび
아버지(높이지 않는 호칭)::父 ちち
꽃::花 はな
선물::プレゼント
유학생::留学生 りゅうがくせい
아버지(높이는 호칭)::お父さん おとうさん
~씨::～さん
영국인, 영국 사람::イギリス人 イギリスじん
고등학교, 고교::高校 こうこう
콘서트::コンサート
오늘 밤::今晩 こんばん
친구::友達 ともだち
어머니(높이지 않는 호칭)::母 はは
꿈::夢 ゆめ
내일::明日 あした
축하::お祝い おいわい
가족::家族 かぞく
학과::学科 がっか
기념일::記念日 きねんび
결혼::結婚 けっこん
설득::説得 せっとく
조부모::祖父母 そふぼ
대만인::台湾人 たいわんじん
~명::～人 ～にん
반대::反対 はんたい
다 함께::みんなで
부모, 양친::両親 りょうしん
같은::同じ おなじ
하다::する
하지만, 그렇지만::でも
저::あの
의사::医者 いしゃ
역::駅 えき
월요일::月曜日 げつようび
여기::ここ
이::この
중학생::中学生 ちゅうがくせい
중국인, 중국 사람::中国人 ちゅうごくじん
외국인::外国人 がいこくじん
교과서::教科書 きょうかしょ
주부::主婦 しゅふ
수요일::水曜日 すいようび
아내::妻 つま
책::本 ほん
우체국::郵便局 ゆうびんきょく
남편(높이지 않는 호칭), 주인::主人 しゅじん
영화관::映画館 えいがかん
그저께::一昨日 おととい
분(사람)::方 かた
형제::兄弟 きょうだい
은행원::銀行員 ぎんこういん
설탕::砂糖 さとう
선생님::先生 せんせい
출구::出口 でぐち
일본::日本 にほん
두 명, 두 사람::二人 ふたり
쉬는 날, 쉼::休み やすみ
입구::入口 いりぐち
~시::～時 ～じ
약속::約束 やくそく
회사::会社 かいしゃ
불쌍한::かわいそうな
조심하다::気を付ける きをつける
아이, 어린이::子ども こども
소금::塩 しお
많이::たくさん
(이름을)짓다::付ける つける
때::時 とき
이름::名前 なまえ
발음::発音 はつおん
이상한::変な へんな
웅덩이::水たまり みずたまり
이미지::イメージ
깨끗한::きれいな
활기넘치는, 건강한, 잘 있는::元気な げんきな
친절한::親切な しんせつな
학생(초중고)::生徒 せいと
소프트한::ソフトな
열성적인::熱心な ねっしんな
물::水 みず
의자::椅子 いす
간단한, 쉬운::簡単な かんたんな
예쁜::きれいな
밥::ご飯 ごはん
충분한::十分な じゅうぶんな
소중한::大切な たいせつな
디자인::デザイン
히라가나::ひらがな
복잡한::複雑な ふくざつな
성실한, 따분한::まじめな
문제::問題 もんだい
편한::楽な らくな
양::量 りょう
여동생(높이지 않는 호칭)::妹 いもうと
시골::田舎 いなか
남자 아이::男の子 おとこのこ
우산::傘 かさ
일, 직업::仕事 しごと
조용한::静かな しずかな
이웃, 이웃집, 옆::隣 となり
여권::パスポート
필요한::必要な ひつような
한가한, 심심한::暇な ひまな
옷::服 ふく
불편한::不便な ふべんな
가게::店 みせ
유명한::有名な ゆうめいな
난폭한::乱暴な らんぼうな
축제::お祭り おまつり
외출::外出 がいしゅつ
위험한::危険な きけんな
부상, 상처::怪我 けが
호화로운::豪華な ごうかな
방해가 되는, 거추장스러운::邪魔な じゃまな
식사::食事 しょくじ
괜찮은::大丈夫な だいじょうぶな
번화한, 활기찬::にぎやかな
짐::荷物 にもつ
파티::パーティー
밤::夜 よる
들르다::寄る よる
안전한::安全な あんぜんな
열심인::一生懸命な いっしょうけんめいな
나라::国 くに
준비::準備 じゅんび
힘든::大変な たいへんな
편리한::便利な べんりな
호텔::ホテル
훌륭한::立派な りっぱな
여행::旅行 りょこう
남동생(높이지 않는 호칭)::弟 おとうと
(무생물이)있다::ある
일(1)::一　 いち
지금::今 いま
운전::運転 うんてん
사다::買う かう
공기::空気 くうき
차(자동차)::車 くるま
경치::景色 けしき
~시간::～時間 ～じかん
슈퍼::スーパー
근처, 가까이::近く ちかく
곳::所 ところ
아주, 매우::とても
없다::ない
버스::バス
병원::病院 びょういん
~편, ~대(운행 댓수)::～本 ～ほん
더::もっと
젊다::若い わかい
할 수 있다::できる
여동생 분::妹さん いもうとさん
어머님::お母様 おかあさま
어머니(높이는 호칭)::お母さん おかあさん
사모님::奥様 おくさま
할아버님::おじい様 おじいさま
할아버지(높이는 호칭)::おじいさん
따님::お嬢様 おじょうさま
남편(높이지 않는 호칭)::夫 おっと
아버님(매우 높이는 호칭)::お父様 おとうさま
남동생 분::弟さん おとうとさん
오빠, 형(매우 높이는 호칭)::お兄様 おにいさま
오빠/형(높이는 호칭)::お兄さん おにいさん
누나, 언니(매우 높이는 호칭)::お姉様 おねえさま
누나/언니(높이는 호칭)::お姉さん おねえさん
할머님::おばあ様 おばあさま
할머니(높이는 호칭)::おばあさん
아드님::お坊ちゃん おぼっちゃん
남편 분::ご主人 ごしゅじん
할아버지(높이지 않는 호칭)::祖父 そふ
할머니(높이지 않는 호칭)::祖母 そぼ
엄마::ママ
아들::息子 むすこ
딸::娘 むすめ
사촌(높이지 않는 호칭)::いとこ
사촌(높이는 호칭)::いとこさん
조카(남자)(높이지 않는 호칭)::甥 おい
조카(남자)(높이는 호칭)::甥御さん おいごさん
사촌(매우 높이는 호칭)::おいとこさん
백부, 숙부 등 부모의 남자 형제 및 그 배우자(남자)(높이지 않는 호칭)::おじ
백부, 숙부 등 부모의 남자 형제 및 그 배우자(남자)(매우 높이는 호칭)::おじ様 おじさま
백부, 숙부 등 부모의 남자 형제 및 그 배우자(남자)(높이는 호칭)::おじさん
큰어머니, 외숙모 등 부모의 자매 및 부모의 형제의 배우자(높이지 않는 호칭)::おば
큰어머니, 외숙모 등 부모의 자매 및 부모의 형제의 배우자(매우 높이는 호칭)::おば様 おばさま
큰어머니, 외숙모 등 부모의 자매 및 부모의 형제의 배우자(높이는 호칭)::おばさん
손주님::お孫さん おまごさん
손주(높이지 않는 호칭)::孫 まご
조카딸(높이지 않는 호칭)::姪 めい
조카딸(높이는 호칭)::姪御さん めいごさん
고르다::選ぶ えらぶ
결과::結果 けっか
답::答え こたえ
아쉬운, 유감스러운::残念な ざんねんな
신선한::新鮮な しんせんな
적당한::適当な てきとうな
특별한::特別な とくべつな
날::日 ひ
새빨간::真っ赤な まっかな
별로, 그다지::あまり
목숨, 생명::命 いのち
그림::絵 え
화가::画家 がか
가능한::可能な かのうな
건강한::健康な けんこうな
행복한::幸せな しあわせな
자연::自然 しぜん
근사한, 멋진::素敵な すてきな
그렇게::そんな(に)
중요한, 소중한::大事な だいじな
테이크아웃, 포장해서 가져감::テイクアウト
신기한, 희안한::不思議な ふしぎな
우수한::優秀な ゆうしゅうな
개::犬　 いぬ
그녀, 여자 친구::彼女 かのじょ
갑작스러운, 급한::急な きゅうな
교수(님)::教授 きょうじゅ
실패, 실수::失敗 しっぱい
화려한(부정적)::派手な はでな
인질::人質 ひとじち
점심밥::昼ごはん ひるごはん
불행한::不幸な ふこうな
무사한::無事な ぶじな
만족스러운::満足な まんぞくな
쓸데없는, 헛된::無駄な むだな
귀찮은, 폐를 끼치는, 성가신::迷惑な めいわくな
메일::メール
내한::来韓 らいかん
심술궂은::意地悪な いじわるな
싫은::嫌な いやな
부인(높이는 호칭)::奥さん おくさん
남자 친구, 그(사람)::彼 かれ
(손)재주가 있는::器用な きような
바보::バカ バカ
전::前 まえ
제멋대로 구는::わがままな わがままな
열심히::一生懸命 いっしょうけんめい
응원::応援 おうえん
생각하다::思う おもう
과정::過程 かてい
열심히 하다, 분발하다::頑張る がんばる
결국::結局 けっきょく
결승::決勝 けっしょう
중요한::重要(な) じゅうよう(な)
전국::全国 ぜんこく
대회::大会 たいかい
팀::チーム
해::年 とし
남다::残る のこる
지다::負ける まける
매니저::マネージャー
모두::みんな
집사람::家内 かない
영어::英語 えいご
나(남자(거친 말))::俺 おれ
싫어하는::嫌いな きらいな
과일::果物 くだもの
잘하는::上手な じょうずな
좋아하는::好きな すきな
잘하는, 능숙한::得意な とくいな
일본어::日本語 にほんご
피아노::ピアノ
잘 못하는::下手な へたな
야채::野菜 やさい
노래::歌 うた
과자::お菓子 おかし
술::お酒 おさけ
한자::漢字 かんじ
글씨, 글자::字 じ
수학::数学 すうがく
부장(님)::部長 ぶちょう
운동::運動 うんどう
수영::水泳 すいえい
스포츠::スポーツ
설명::説明 せつめい
댄스, 춤::ダンス
중국어::中国語 ちゅうごくご
점원::店員 てんいん
당신::あなた あなた
반(학교), 클래스::クラス
사이, 동안::間 あいだ
의미::意味 いみ
가사::家事 かじ
가라오케, 노래방::カラオケ
속담::ことわざ ことわざ
예를 들면::例えば たとえば
가능하면::できれば できれば
길다, 오래이다::長い ながい
되다::なる
혼자서::一人で ひとりで
것::もの
자주::よく よく
가다::行く いく
그러고 나서, 그 이후, 그리고::それから それから
그러나::しかし
일::こと
따뜻하다::温かい あたたかい
새롭다::新しい あたらしい
뜨겁다::熱い あつい
우표::切手 きって
신발, 구두::靴 くつ
커피::コーヒー
주스::ジュース
수프::スープ
차갑다::冷たい つめたい
오래되다, 낡다::古い ふるい
가을::秋 あき
두껍다::厚い あつい
덥다::暑い あつい
얇다, 연하다::薄い うすい
집::うち
크다::大きい おおきい
목욕, 욕실, 욕조::お風呂 おふろ
뜨거운 물::お湯 おゆ
벽::壁 かべ
춥다::寒い さむい
선선하다, 서늘하다::涼しい すずしい
여름::夏 なつ
미지근하다::ぬるい
노트::ノート
봄::春 はる
겨울::冬 ふゆ
밝다::明るい あかるい
겉옷, 상의::上着 うわぎ
무겁다::重い おもい
가방::かばん
가볍다::軽い かるい
어둡다::暗い くらい
계산::計算 けいさん
바같::外 そと
작다::小さい ちいさい
시험, 퀴즈(테스트)::テスト
방::部屋 へや
어렵다::難しい むずかしい
쉽다::やさしい
바쁘다::忙しい いそがしい
바다::海 うみ
많다::多い おおい
손님::お客さん おきゃくさん
접시::お皿 おさら
선물(여행지에서 사오는), 토산품::お土産 おみやげ
골(goal)::ゴール
종류::種類 しゅるい
적다::少ない すくない
가깝다::近い ちかい
멀다::遠い とおい
음악::音楽 おんがく
꽃병::花瓶 かびん
종이::紙 かみ
머리::頭 あたま
색, 색깔::色 いろ
끝나다::終わる おわる
머리카락::髪 かみ
기분::気分 きぶん
목::首 くび
계속::ずっと
염색하다::染める そめる
좀, 약간::ちょっと
일찍::早く はやく
후지산(산 이름)::富士山 ふじさん
아직::まだ
짧게::短く みじかく
이제 곧::もうすぐ
재미있다::面白い おもしろい
샤프::シャーペン
스카프::スカーフ スカーフ
좁다::狭い せまい
비싸다::高い たかい
도서관::図書館 としょかん
마당::庭 にわ
넓다::広い ひろい
싸다::安い やすい
나쁘다::悪い わるい
소설::小説 しょうせつ
농담::冗談 じょうだん
선수::選手 せんしゅ
재미없다::つまらない
강하다::強い つよい
낮다::低い ひくい
산::山 やま
약하다::弱い よわい
팔::腕 うで
인생::人生 じんせい
여름방학::夏休み なつやすみ
굵다::太い ふとい
가늘다::細い ほそい
짧다::短い みじかい
손가락, 발가락::指 ゆび
아프다::痛い いたい
인터넷::インターネット
느리다, 늦다::遅い おそい
해외여행::海外旅行 かいがい りょこう
귀엽다, 예쁘다::かわいい
스트레이트, 직구::ストレート
스피드, 속도::スピード
즐겁다::楽しい たのしい
주사::注射 ちゅうしゃ
고양이::猫 ねこ
빠르다::速い はやい
투수::ピッチャー ピッチャー
달다::甘い あまい
맛있다::おいしい
맵다::辛い からい
카레::カレー
검다, 까맣다::黒い くろい
케이크::ケーキ
시간::時間 じかん
일본요리::日本料理 にほんりょうり
저녁밥::晩ごはん ばんごはん
맛없다::まずい まずい
이외::以外 いがい
의견::意見 いけん
엘리베이터::エレベーター
관리비::管理費 かんりひ
묻다::聞く きく
고층::高層 こうそう
무섭다::怖い こわい
지진::地震 じしん
시설::施設 しせつ
타워맨션(고층아파트)::タワーマンション
점::点 てん
전망, 조망::眺め ながめ
기다리다::待つ まつ
아파트::マンション
벌레::虫 むし
부르다::呼ぶ よぶ
돈::金 かね
짜다::塩辛い しおからい
떫다::渋い しぶい
(맛이)쓰다::苦い にがい
차, 다도::お茶 おちゃ
쓰다::書く かく
마시다::飲む のむ
앱::アプリ
보내다, 부치다::送る おくる
빌려주다::貸す かす
애인, 연인::恋人 こいびと
설명서::説明書 せつめいしょ
편지::手紙 てがみ
동영상::動画 どうが
찍다::撮る とる
입학::入学 にゅうがく
불::火 ひ
읽다::読む よむ
기뻐하다::喜ぶ よろこぶ
서두르다::急ぐ いそぐ
(냄새를)맡다::かぐ
듣다::聞く きく
클래식::クラシック
바지::ズボン
슬리퍼::スリッパ
냄새::におい
벗다::脱ぐ ぬぐ
바이올린::バイオリン
신다::履く はく
연주하다, (악기를)치다::弾く ひく
(노래를)부르다::歌う うたう
치다(때리다)::打つ うつ
팔다::売る うる
(모자를)쓰다::かぶる
스티커::シール
(담배를)피우다, 들이마시다::吸う すう
담배::たばこ
(풀 등으로)붙이다::貼る はる
히트::ヒット
안타::ヒット
모자::帽子 ぼうし
가지다, (손에)들다::持つ もつ
발, 다리::足 あし
청소::掃除 そうじ
졸업::卒業 そつぎょう
부탁하다, 의뢰하다::頼む たのむ
책상::机 つくえ
운반하다, 나르다::運ぶ はこぶ
밟다::踏む ふむ
메뉴::メニュー
누르다::押す おす
돌려주다::返す かえす
(우산을)쓰다::さす
내다, 제출하다::出す だす
분실하다, 잃어버리다::なくす
단추, 버튼::ボタン
리포트::レポート
씻다::洗う あらう
화장실::お手洗い おてあらい
작년::去年 きょねん
자르다::切る きる
게임::ゲーム
즐기다::楽しむ たのしむ
초콜릿::チョコレート
손::手 て
이(치아)::歯 は
닦다::磨く みがく
유럽::ヨーロッパ
건네주다, 주다::渡す わたす
미국::アメリカ
사이즈::サイズ
연주::演奏 えんそう
연주회::演奏会 えんそうかい
반드시::必ず かならず
꽤, 제법::かなり かなり
결혼식::結婚式 けっこんしき
취미::趣味 しゅみ
지난주::先週 せんしゅう
가끔::時々 ときどき
토요일::土曜日 どようび
보여주다::見せる みせる
영화::映画 えいが
약::薬 くすり
양말::靴下 くつした
수업::授業 じゅぎょう
전기, 불::電気 でんき
빵::パン
쉬다::休む やすむ
사실::事実 じじつ
알다::知る しる
신문::新聞 しんぶん
이야기하다::話す はなす
받다::もらう
컵::カップ
관심, 흥미::興味 きょうみ
잡지::雑誌 ざっし
J-POP::J-POP(ジェイポップ)
자동차::自動車 じどうしゃ
만들다::作る つくる
테이블::テーブル
사진::写真 しゃしん
치마::スカート
배우다::習う ならう
(하반신에 입는 옷을)입다::はく
관한::関する かんする
조금, 약간::少し すこし
전혀::全然 ぜんぜん
전부::全部 ぜんぶ
중국요리, 중화요리::中華料理 ちゅうかりょうり
중국::中国 ちゅうごく
나머지, 남은 것::残り のこり
베스트셀러::ベストセラー ベストセラー
서점, 책방::本屋 ほんや
기모노::着物 きもの
입다::着る きる
닫다::閉める しめる
먹다::食べる たべる
문::ドア
창문::窓 まど
보다::見る みる
야식, 밤참::夜食 やしょく
뒤집어쓰다, 쬐다::浴びる あびる
가르치다::教える おしえる
외우다, 기억하다::覚える おぼえる
(전화를)걸다::かける かける
빌리다::借りる かりる
한국어::韓国語 かんこくご
샤워::シャワー
힘::力 ちから
켜다::つける
전화::電話 でんわ
전화번호::電話番号 でんわ ばんごう
벨트::ベルト
잊어버리다, 잊다, 두고 오다::忘れる わすれる
모으다::集める あつめる
넣다::入れる いれる
쓰레기::ごみ ごみ
버리다::捨てる　 すてる
늘어놓다, 나란히 놓다::並べる ならべる
인기::人気 にんき
시작하다::始める はじめる
프랑스어::フランス語 フランスご
공부::勉強 べんきょう
메일주소::メールアドレス
예정::予定 よてい
정리되다::片付く かたづく
생각::考え かんがえ
~개::～個 ～こ
소중히::大事に だいじに
서랍::引き出し ひきだし
필요::必要 ひつよう
~분간::～分間 ～ふんかん
거의::ほとんど
우선::まず
물건::もの
잘::よく よく
연습::練習 れんしゅう
심다::植える うえる
(안경을)쓰다::かける かける
나무::木 き
김치::キムチ
알아보다, 조사하다::調べる しらべる
짓다, 세우다::建てる たてる
담그다::漬ける つける
비행기::飛行機 ひこうき
안경::眼鏡 メガネ
올리다::上げる あげる
못살게 굴다, 괴롭히다::いじめる
치우다, 정리하다::片付ける かたづける
정하다::決める きめる
클래스메이트, 같은 반 친구::クラスメイト
코스트, 비용::コスト
내리다::下げる さげる
건전지::電池 でんち
갖다주다, 신고하다::届ける とどける
갈다, 교체하다::取り替える とりかえる
도둑::泥棒 どろぼう
일기::日記 にっき
값, 가격::値段 ねだん
찾다, 발견하다::見つける みつける
옛날::昔 むかし
(회사, 일 등을)그만두다::辞める やめる
분실물, 두고 간/온 물건::忘れ物 わすれもの
붙잡다, 잡다::捕まえる つかまえる
(시험을)보다::受ける うける
시험::試験 しけん
계속하다::続ける つづける
세우다, 멈추게 하다, 말리다::止める とめる
칭한하다::ほめる
툴라더, 잘못하다::間違える まちがえる
길::道 みち
말하다::言う いう
깨끗하게, 깨끗이::きれいに
셔츠::シャツ
빨래, 세탁::洗濯 せんたく
주문::注文 ちゅうもん
전시품::展示品 てんじひん
이제::もう
아침::朝 あさ
모레::明後日 あさって
회장(님)::会長 かいちょう
쇼핑, 장보기::買い物 かいもの
경쟁::競争 きょうそう
오다::来る くる
강의::講義 こうぎ
남자친구::彼氏 かれし
싸움::けんか
연구::研究 けんきゅう
질문::質問 しつもん
테니스::テニス
대답, 답장::返事 へんじ
로봇::ロボット
안내::案内 あんない
뒷면, 뒤::裏 うら
교장 선생님::校長先生 こうちょうせんせい
전철::電車 でんしゃ
사고방식::考え方 かんがえかた
커뮤니케이션::コミュニケーション
이런::こんな
수단::手段 しゅだん
여성::女性 じょせい
걱정::心配 しんぱい
바로::すぐに
대개, 대부분::大概 たいがい
대부분::大部分 だいぶぶん
남성::男性 だんせい
차이::違い ちがい
다르다::違う ちがう
통신::通信 つうしん
도구::道具 どうぐ
취하다::取る とる
이해::理解 りかい
연락::連絡 れんらく
그러니까, 그러기 때문에::だから だから
영어회화::英会話 えいかいわ
하숙::下宿 げしゅく
구경::見物 けんぶつ
차장(님)::次長 じちょう
상무(님)::常務 じょうむ
전무(님)::専務 せんむ
불꽃놀이::花火 はなび
매일::毎日 まいにち
다음 주::来週 らいしゅう
아르바이트::アルバイト
선물::贈り物 おくりもの
자녀분::お子さん おこさん
남자::男の人 おとこのひと
회의::会議 かいぎ
계장(님)::係長 かかりちょう
경험::経験 けいけん
오후::午後 ごご
부모님::ご両親 ごりょうしん
편의점::コンビニ コンビニ
준비, 채비::支度 したく
주임(님)::主任 しゅにん
상사::上司 じょうし
직장::職場 しょくば
동료::同僚 どうりょう
운전수, 운전기사::運転手 うんてんしゅ
경찰아저씨::お巡りさん おまわりさん
사례, 감사의 말/선물::お礼 おれい
여자::女の人 おんなのひと
회화::会話 かいわ
자기소개::自己紹介 じこしょうかい
부하::部下 ぶか
~후::後 あと
함께, 같이::一緒に いっしょに
덕분에::おかげで
재작년::おととし
추억::思い出 おもいで
돌아가다, 돌아오다::帰る かえる
한국::韓国 かんこく
그리고::そして そして
~년간::～年間 ～ねんかん
다음 달::来月 らいげつ
열리다::開く あく
비다::空く あく
닫히다::閉まる しまる
자리::席 せき
날다::飛ぶ とぶ
새(동물)::鳥 とり
하나::一つ ひとつ
병::ビン ビン
뚜껑::フタ フタ
웃다::笑う わらう
일어나다::起きる おきる
고등학생::高校生 こうこうせい
초대::招待 しょうたい
차가워지다, 식다::冷える ひえる
펜::ペン ペン
더러워지다::汚れる よごれる
깨지다::割れる われる
인사::挨拶 あいさつ
갔다오다::行ってくる いってくる
근처, 이웃집::近所 きんじょ
소개::紹介 しょうかい
들다, 걸리다::かかる かかる
화장::火葬 かそう
화장식::火葬式 かそうしき
가족장::家族葬 かぞくそう
앞으로, 지금부터::これから これから
최근, 요즘::最近 さいきん
친하다::親しい したしい
정신적::精神的 せいしんてき
장례식::葬式 そうしき
피로::疲れ つかれ
~적::～的 ～てき
세상을 뜨다::亡くなる なくなる
외동::一人っ子 ひとりっこ
늘다, 증가하다, 많아지다::増える ふえる
천천히::ゆっくり ゆっくり
이별, 작별::別れ わかれ
놀다::遊ぶ あそぶ
위스키, 양주::ウイスキー
서다::立つ たつ
열다::開ける あける
복사::コピー
서류::書類 しょるい
지도::地図 ちず
가져오다, 가지고 오다::持ってくる もってくる
독일어::ドイツ語 ドイツご
헤어지다::別れる わかれる
가수::歌手 かしゅ
유도::柔道 じゅうどう
단어::単語 たんご
외출하다::出かける でかける
팬::ファン
정부, 첩::愛人 あいじん
공주님::お姫様 おひめさま
생각나다, 상기하다::思い出す おもいだす
후배::後輩 こうはい
(꽃이)피다::咲く さく
벚꽃::桜 さくら
선배::先輩 せんぱい
키우다::育てる そだてる
잠들다, 자다::眠る ねむる
달리다::走る はしる
발매, 출시::発売 はつばい
줍다::拾う ひろう
고향::ふるさと
볼::ボール
사과::リンゴ
비::雨 あめ
구름::雲 くも
얼다::凍る こおる
바나나::バナナ
(비나 눈 등이) 내리다::降る ふる
함께 하는::一緒の いっしょの
말을 걸다::声をかける こえをかける
자기, 자신::自分 じぶん
그런, 그러한::そういう
그런::そんな
타입::タイプ
술모임::飲み会 のみかい
다른::他の ほかの
무리하게::無理に むりに
부모, 어버이::親 おや
야단치다, 꾸짖다::叱る しかる
험담, 욕::悪口 わるぐち
스타일::スタイル
주의::注意 ちゅうい
데려오다, 데리고 오다::連れてくる つれてくる
싣다::載せる のせる
실수, 실패::ミス
이탈리아어::イタリア語 イタリアご
(깨)물다, 씹다::噛む かむ
번역::翻訳 ほんやく
지갑::財布 さいふ
소매치기::すり
훔치다::盗む ぬすむ
카메라::カメラ
고장내다, 망가뜨리다::壊す こわす
죽다::死ぬ しぬ
체크::チェック
점수::点 てん
안, 속::中 なか
울다::泣く なく
시어머니, 장모::義理の母 ぎりのはは
도망치다::逃げる にげる
범인::犯人 はんにん
안심::安心 あんしん
걸치다::かける
의리::義理 ぎり
좀처럼::なかなか
이야기::話 はなし
깜짝 놀라다::びっくりする
양다리::二股 ふたまた
차다, 흔들다::振る ふる
프로포즈, 청혼::プロポーズ プロポーズ
벌써, 이미::もう
꼭, 아마도::きっと
(생물이)있다::いる
공장::工場 こうじょう
일하다::働く はたらく
사건::事件 じけん
토지, 땅::土地 とち
고치다, 수리하다::直す なおす
피망::ピーマン
끊다, 그만두다::やめる
돌아오다::帰ってくる かえってくる
돌아감, 돌아갈 때::帰り かえり
행사::行事 ぎょうじ
참가::参加 さんか
퇴학::退学 たいがく
반성문::反省文 はんせいぶん
~분::～分 ～ふん
늦게::遅く おそく
과장(님)::課長 かちょう
잔업, 야근::残業 ざんぎょう
도와주다, 거들어 주다::手伝う てつだう
이상::以上 いじょう
접수::受付 うけつけ
옮기다, 전염시키다::移す うつす
환자::患者 かんじゃ
검사::検査 けんさ
진료::診療 しんりょう
되도록, 가능한 한::できるだけ
특히, 특별히::特に とくに
길게::長く ながく
또, 다시::また
문진표(병원에서 진료를 받기 전에 몸의 상태, 병력, 알레르기 유무 등에 대해 써는 서류)::問診票 もんしんひょう
약국::薬局 やっきょく
개다::晴れる はれる
만나다::会う あう
인터폰::インターホン
놓다, 두다::置く おく
~월::～月 ～がつ
금요일::金曜日 きんようび
올해, 금년::今年 ことし
소파::ソファー
TV::テレビ
울리다::鳴る なる
앞::前 まえ
라이브(콘서트)::ライブ
주다::あげる
소리::音 おと
세뱃돈::お年玉 おとしだま
헤엄치다::泳ぐ およぐ
부러지다::折れる おれる
들리다::聞こえる きこえる
수도::水道 すいどう
나오다, 나가다, 나다::出る でる
나이프::ナイフ
자다::寝る ねる
호수::湖 みずうみ
어젯밤::夕べ ゆうべ
우리들, 저희들::私たち わたしたち
~들::～たち
규육::教育 きょういく
신입사원::新入社員 しんにゅうしゃいん
특별::特別 とくべつ
(방송)프로그램::番組 ばんぐみ
도시락::弁当 べんとう
방송::放送 ほうそう
항상::いつも
받다::受ける うける
대학(교)::大学 だいがく
찬스, 기회::チャンス
들어가다, 들어오다::入る はいる
무명, 이름이 없음::無名 むめい
유튜브::You Tube ユーチューブ
레슨::レッスン
화제::話題 わだい
기분, 느낌, 마음::気 き
느낌이 들다, 생각이 들다::気がする きがする
목소리::声 こえ
걷다::歩く あるく
바람::風 かぜ
흐리다::曇る くもる
공원::公園 こうえん
교차로::交差点 こうさてん
오전::午前 ごぜん
다음, 이번::次 つぎ
강하게, 세게::強く つよく
알바::バイト
매일 아침::毎朝 まいあさ
돌다, 꺾다::曲がる まがる
오른쪽::右 みぎ
아르헨티나::アルゼンチン
많이(사람)::大勢 おおぜい
(전철, 버스 등에서)내리다::降りる おりる
관광객::観光客 かんこうきゃく
시합::試合 しあい
자동적으로::自動的に じどうてきに
알리다::知らせる しらせる
정류장::停留所 ていりゅうじょ
시계::時計 とけい
별::星 ほし
이쪽(정중함)::こちら
이번주::今週 こんしゅう
주말::週末 しゅうまつ
태풍::台風 たいふう
넥타이::ネクタイ
꽃구경::花見 はなみ
여러 가지::色々 いろいろ
워킹::ウォーキング
기쁘다::うれしい
귀로, 돌아오는 길::帰り道 かえりみち
이어지다, 계속되다::続く つづく
멀리::遠く とおく
오래간만에::久しぶりに ひさしぶりに
보이다::見える みえる
3일::三日 みっか
정도::～くらい
이쪽::こっち
멈추다::止まる とまる
스트레스::ストレス
저것::あれ
돌::石 いし
~살, ~세::～歳 ～さい
초등학교::小学校 しょうがっこう
던지다::投げる なげる
~학년::～年生 ねんせい
몹시::ひどく
창유리::窓ガラス まどガラス
더욱::余計に よけいに
나아가다, 진척하다::進む すすむ
홈런::ホームラン
사양::遠慮 えんりょ
안전띠::シートベルト
매다, 조이다::締める しめる
전하다::伝える つたえる
놈, 녀석::奴 やつ
보살핌, 돌봄::世話 せわ
복습::復習 ふくしゅう
예습::予習 よしゅう
~엔::～円 ～えん
순순히, 얌전히::大人しく おとなしく
너::お前 おまえ
경찰::警察 けいさつ
현금::現金 げんきん
죽이다::殺す ころす
절대(로), 꼭, 틀림없이::絶対(に) ぜったい（に）
누군가::誰か だれか
장소::場所 ばしょ
만::万 まん
잡다, 쥐다::つかむ
움직이다::動く うごく
이기다::勝つ かつ
자전거::自転車 じてんしゃ
자유롭게::自由に じゆうに
올라가다::登る のぼる
(탈 것에)타다::乗る のる
낮, 점심::昼 ひる
애완동물::ペット ペット
기숙사::寮 りょう
살다(생존하다)::生きる いきる
강::川 かわ
쉽게::簡単に かんたんに
상어::サメ サメ
세우다::立てる たてる
근무하다::勤める つとめる
펜케이스, 필통::ペンケース ペンケース
살이 빠지다, 살을 빼다::やせる
가페, 커피숍::カフェ
심야::深夜 しんや
잎::葉 は
론, 대부(금)::ローン
내후년::再来年 さらいねん
출석::出席 しゅっせき
생활::生活 せいかつ
퇴원::退院 たいいん
당일치기::日帰り ひがえり
부산(지명)::プサン
여자 아이::女の子 おんなのこ
카드::カード カード
모양, 형태::形 かたち
만지다, 손대다::触る さわる
전원::全員 ぜんいん
사용하다::使う つかう
티셔츠::Tシャツ ティーシャツ
투표::投票 とうひょう
동물::動物 どうぶつ
동물원::動物園 どうぶつえん
백(bag)::バッグ
포인트::ポイント
내년::来年 らいねん
간호사::看護師 かんごし
갑자기::急に きゅうに
휠체어::車椅子 くるまいす
허리::腰 こし
답하다, 대답하다::答える こたえる
정형외과::整形外科 せいけいげか
살아나다, 도움이 되다::助かる たすかる
일어서다::立ち上がる たちあがる
(병이)낫다::治る なおる
마중하다, 맞이하다::迎える むかえる
알다, 이해하다::わかる
캠핑::キャンプ
마지막, 최후::最後 さいご
취소, 중지::中止 ちゅうし
다리::橋 はし
건너다::渡る わたる
어르신, 노인::お年寄り おとしより
끝::終わり おわり
고령자::高齢者 こうれいしゃ
시니어::シニア
섬::島 しま
수술::手術 しゅじゅつ
실버::シルバー
지나다::過ぎる すぎる
한사내지다::空く すく
도착하다::着く つく
특급(열차)::特急 とっきゅう
익숙해지다::慣れる なれる
노리다, 겨누다::狙う ねらう
갈아타다::乗り換える のりかえる
양보하다::譲る ゆずる
해결::解決 かいけつ
전문가::専門家 せんもんか
상담, 상의::相談 そうだん
중학교::中学校 ちゅうがっこう
캠핑장::キャンプ場 キャンプじょう
다음다음 주::再来週 さらいしゅう
훨씬::ずっと
기대되는::楽しみな たのしみな
낚시::釣り つり
바비큐::バーベキュー
~박(숙박)::～泊 ～はく
홋카이도::北海道 ほっかいどう
4일::4日 よっか
예약::予約 よやく
노인::老人 ろうじん
게다가::それに
모이다::集まる あつまる
연립::アパート
춤추다::踊る おどる
찾다::探す さがす
즐겁게::楽しく たのしく
제대로::ちゃんと
줄서다::並ぶ ならぶ
이사하다::引っ越す ひっこす
회장::会場 かいじょう
감사::感謝 かんしゃ
마음::気持ち きもち
이제 슬슬::そろそろ
레코드판::レコード
호주::オーストラリア
계획::計画 けいかく
출발::出発 しゅっぱつ
~위::～位 ～い
(속도를)줄이다::落とす おとす
휴대전화::携帯電話 けいたい でんわ
교통::交通 こうつう
좌우::左右 さゆう
사고::事故 じこ
집중::集中 しゅうちゅう
신호등::信号 しんごう
스마트폰::スマートフォン
제~::第～ だい～
드라이버, 운전자::ドライバー
하면서 걷기::ながら歩き ながらあるき
발생::発生 はっせい
약간 일찍::早め はやめ
보행자::歩行者 ほこうしゃ
동네, 도시::町 まち
지키다::守る まもる
해질녘, 저녁 어두워지는 때, 저녁 때::夕方 ゆうがた
라이트::ライト ライト
랭킹::ランキング
~(하는)중::～中 ～ちゅう
완성::完成 かんせい
떠들다::騒ぐ さわぐ
(사람 외의 동물이)울다::鳴く なく
끌다::引く ひく
당기다::引く ひく
흘린 물건, 분실물::落し物 おとしもの
다니다::通う かよう
무대, 스테이지::ステージ
취득하다::取る とる
발레::バレエ
비자::ビザ
깨우다, 일으키다::起こす おこす
떨어뜨리다::落とす おとす
껌::ガム ガム
작은 새::小鳥 ことり
포장하다, 싸다::包む つつむ
상자::箱 はこ
그치다, 멈추다::やむ
끓이다::沸かす わかす
늦다::遅れる おくれる
(걱정을)끼치다::かける
걸다::かける
대사관::大使館 たいしかん
피곤해지다::疲れる つかれる
(병을)고치다::治す　 なおす
젖다::濡れる ぬれる
눈::目 め
성::城 しろ
입원::入院 にゅういん
면허증::免許 めんきょ
화내다::怒る おこる
감기::風邪 かぜ
화요일::火曜日 かようび
커닝::カンニング
자동차운전학원::教習所 きょうしゅうじょ
~번(순번)::～番 ～ばん
(감기에)걸리다::ひく
볼일::用事 ようじ
4번타자::4番バッター よばんバッター
숙박시키다, 재우다::泊める とめる
반::半 はん
신분증명서::身分証明書 みぶんしょうめいしょ
이전::以前 いぜん
얼굴::顔 かお
갈아입다::着替える きがえる/きかえる
곤란하다, 난처하다::困る こまる
지각::遅刻 ちこく
단정히 하다, 정돈하다::整える ととのえる
패턴::パターン
기온::気温 きおん
그렇게, 그 정도로::それほど
높다::高い たかい
무엇, 몇::何 なに／なん
파랑, 파란색::青 あお
태어나다::生まれる うまれる
~곡::～曲 ～きょく
강아지::子犬 こいぬ
뉴스::ニュース
당근::ニンジン
재떨이::灰皿 はいざら
시작되다::始まる はじまる
불다::吹く ふく
용돈::お小遣い おこづかい
벌다::稼ぐ かせぐ
가타카나::カタカナ
신용카드::クレジットカード
홍차::紅茶 こうちゃ
골프::ゴルフ
튼튼한::丈夫な じょうぶな
스케이트::スケート スケート
계란::卵 たまご
봉제인형::ぬいぐるみ
마실 것::飲み物 のみもの
지불하다::払う はらう
판다::パンダ
갖고 싶다, 탐나다, 원하다::欲しい ほしい
책장::本棚 ほんだな
집세::家賃 やちん
누구::誰 だれ
자네, 그대, 너::君 きみ
충분히::十分に じゅうぶん(に)
어떻게::どう
트럭::トラック
~톤::～t(トン)
졸리다::眠い ねむい
따뜻하게 하다, 데우다::温める あたためる
기도하다, 빌다::祈る いのる
계시다::いらっしゃる
(몸의)배::おなか
지난번, 요전, 저번::この前 このまえ
성공::成功 せいこう
담당::担当 たんとう
무언가::何か なにか
인형::人形 にんぎょう
포스터::ポスター
말씀드리다, 말하다(공손한 말)::申す もうす
여보세요::もしもし
공항::空港 くうこう
왼쪽::左 ひだり
빨강, 빨간색::赤 あか
운동장::グラウンド
하늘::空 そら
도쿄(지명)::東京 とうきょう
아이디어::アイディア
사탕::飴 あめ
열쇠::鍵 かぎ
더럽다::汚い きたない
작문::作文 さくぶん
매우 좋아하는::大好きな だいすきな
장갑::手袋 てぶくろ
오토바이::バイク
훌륭하다::素晴らしい すばらしい
연하::年下 としした
문장::文章 ぶんしょう
주세요, 주십시오::下さい ください
연못::池 いけ
하루::一日 いちにち
가득::いっぱい
필요하다::要る いる
놀라다::驚く おどろく
아무도::誰も だれも
날씨::天気 てんき
어디::どこ
한 명, 혼자::一人　 ひとり
미터::m メートル
아름답다::美しい うつくしい
떨어지다::落ちる おちる
~회, ~번::～回 ～かい
엄격하다::厳しい きびしい
넘다::超える こえる
~도(온도)::～度 ～ど
어느 쪽(정중함)::どちら
어느 것::どれ
~년::～年 ～ねん
와이셔츠::ワイシャツ
몸::体 からだ
교감선생님::教頭先生 きょうとう せんせい
붐비다::混む こむ
둥글다::丸い まるい
무리한::無理な むりな
리프레시::リフレッシュ
스태프::スタッフ
옳다::正しい ただしい
안 되는::だめな
축하금::お祝い金 おいわいきん
바꾸다::変える かえる
코스 요리::コース料理 コースりょうり
축의금::ご祝儀 ごしゅうぎ
이렇게::こんなに
초대장::招待状 しょうたいじょう
친척::親戚 しんせき
거기에다, 그리고::それと
~값, ~대금::～代 ~だい
왜::なぜ
경우::場合 ばあい
한 명 한 명, 한 사람, 한 사람::一人ひとり ひとりひとり
보통::普通 ふつう
교토(지명)::京都 きょうと
친정, 부모님 집::実家 じっか
필리핀::フィリピン
저쪽(정중함)::あちら あちら
빈(지명)::ウィーン
위::上 うえ
에스컬레이터::エスカレーター
오키나와(지면)::沖縄 おきなわ
살다(거주하다)::住む すむ
앉다::座る すわる
지난달::先月 せんげつ
택시::タクシー
밭::畑 はたけ
매년::毎年 まいとし
광주::クァンジュ
오늘 아침::今朝 けさ
이번 달::今月 こんげつ
~주간::～週間 ～しゅうかん
~일::～日 ～にち
촛불시위::ろうそくデモ ろうそくデモ
한 번::一度 いちど
올림픽::オリンピック オリンピック
온천::温泉 おんせん
~개월::～ヶ月 ～かげつ
빚::借金 しゃっきん
비누::石けん せっけん
~도(횟수)::～度 ～ど
팸플릿::パンフレット
미용실::美容院 びよういん
열다, 펴다::開く ひらく
식당::食堂 しょくどう
디즈니랜드::ディズニーランド
손수건::ハンカチ
수영장::プール
반지::指輪 ゆびわ
이유::理由 りゆう
교회::教会 きょうかい
스페인어::スペイン語 スペインご
목걸이::ネックレス ネックレス
가위::はさみ
젓가락::箸 はし
예배::礼拝 れいはい
뜨다::編む あむ　
운동회::運動会 うんどうかい
연기::延期 えんき
가구::家具 かぐ
우유팩::牛乳パック ぎゅうにゅうパック
털실::毛糸 けいと
쌀::米 こめ
스웨터::セーター セーター
쓰러지다::倒れる たおれる
요리::料理 りょうり
오사카(지명)::大阪 おおさか
킬로(미터)::キロ（メートル）
공사::工事 こうじ
나고야(지명)::名古屋 なごや
백(100)::百 ひゃく
2일::二日 ふつか
세 개::三つ みっつ
목적지::目的地 もくてきち
연휴::連休 れんきゅう
구멍::穴 あな
굴뚝::煙突 えんとつ
해안::海岸 かいがん
급료, 월급::給料 きゅうりょう
사무실, 사무소::事務所 じむしょ
나가다::出ていく でていく
내정::内定 ないてい
엿보다, 들여다 보다::覗く のぞく
힌트::ヒント
발자국::足跡 あしあと
우유::牛乳 ぎゅうにゅう
건강::健康 けんこう
밀가루::小麦粉 こむぎこ
~상::～上 ～じょう
석유::石油 せきゆ
타이어, 바퀴::タイヤ タイヤ
치즈::チーズ
복장, 옷차림::服装 ふくそう
포도::ぶどう
와인::ワイン ワイン
시끄럽다::うるさい
감정::感情 かんじょう
공연::公演 こうえん
표정::表情 ひょうじょう
부주의::不注意 ふちゅうい
분석::分析 ぶんせき
위험하다::危ない あぶない
아무것도::何も なにも
깊다::深い ふかい
매화(나무), 매실::梅 うめ
행하다::行う おこなう
개시, 시작::開始 かいし
삿포로(지명)::札幌 さっぽろ
심포지엄::シンポジウム
성적::成績 せいせき
맥주::ビール ビール
남쪽::南 みなみ
실::糸 いと
웨딩드레스::ウェディングドレス
소문::噂 うわさ
키::背 せ
미인::美人 びじん
렌털::レンタル
영업::営業 えいぎょう
데려다 주다::送る おくる
커튼::カーテン
참다::我慢する がまんする
크리스마스::クリスマス
저물다, (해가)지다::暮れる くれる
사과하다::謝る あやまる
(과일)감::柿 かき
침실::寝室 しんしつ
진로::進路 しんろ
묵다, 숙박하다::泊まる とまる
도둑질::盗み ぬすみ
남기다::残す のこす
겨울방학::冬休み ふゆやすみ
열매::実 み
놀리다::からかう からかう
그저, 다만, 단지::ただ ただ
컵라면::カップラーメン
믿다::信じる しんじる
드라마::ドラマ
불평::文句 もんく
맞다::当たる あたる
화재::火事 かじ
소방서::消防署 しょうぼうしょ
대원::隊員 たいいん
당직::当直 とうちょく
정말로::本当に ほんとうに
원래::もともと
외국::外国 がいこく
외롭다, 쓸쓸하다::寂しい さびしい
~등(순위)::～番 ～ばん
어떻게(정중함)::いかが いかが
정말, 사실::本当 ほんとう
앙케트, 설문조사::アンケート
언젠가::いつか
팔리다::売れる うれる
~층::～階 ～かい
계단::階段 かいだん
숟가락, 스푼::スプーン
어딘가::どこか
2차(모임)::二次会 にじかい
분명히, 똑똑히::はっきり はっきり
포크::フォーク
언제::いつ
어떤::どんな
고민하다::悩む なやむ
이사::引っ越し ひっこし
점심 (휴식) 시간::昼休み ひるやすみ
리더::リーダー
멋지다, 잘생겼다::かっこいい
이따가, 나중에::後で あとで
게::カニ
본고장::本場 ほんば
역시::やっぱり
나머지::あと あと
출신::出身 しゅっしん
쪽::方 ほう
조금 더::もう少し もうすこし
목요일::木曜日 もくようび
표::切符 きっぷ
급행(열차)::急行 きゅうこう
족하다::足りる たりる
인원수::人数 にんずう
끓다::沸く　 わく
모임::集まり あつまり
꾀병::仮病 けびょう
타이밍::タイミング
(거짓말을)하다::つく
대신에::代わりに かわりに
쓰레기봉투::ごみ袋 ごみぶくろ
정식하게::正直に しょうじきに
두 개, 둘::二つ ふたつ
어머::まあ まあ
아기::赤ん坊 あかんぼう
큰비::大雨 おおあめ
천둥::雷 かみなり
미술관::美術館 びじゅつかん
아, 어::あ
네(네/아니요)::はい
물론::勿論 もちろん
후추::コショウ
간장::しょう油 しょうゆ
시다::酸っぱい すっぱい
주방::台所 だいどころ
먹을 것::食べ物 たべもの
배낭::リュック
에어컨::エアコン
싸게::安く やすく
요구르트::ヨーグルト
냉장고::冷蔵庫 れいぞうこ
셋집 주인::大家さん おおやさん
버터::バター
굽다::焼く やく
경제력::経済力 けいざいりょく
나이::年 とし
(나이를)먹다::取る とる
건네주다, 잡다::取る とる
(점수를)받다::取る とる
어울리다::似合う にあう
혼자 사는 것::一人暮らし ひとりぐらし
살찌다::太る ふとる
어른::大人 おとな
장난감::おもちゃ
스코어::スコア
고기::肉 にく
프로::プロ
언제든지::いつでも
괌::グアム
아시아::アジア
아프리카::アフリカ
매장::売場 うりば
크기::大きさ おおきさ
밥공기, 찻종::お茶碗 おちゃわん
소고기::牛肉 ぎゅうにく
생선, 물고기::魚 さかな
정리::整理 せいり
접객, 손님을 대하는 것::接客 せっきゃく
만화(책)::漫画 まんが
쉬는 시간::休み時間 やすみじかん
활동::活動 かつどう
환경::環境 かんきょう
살다::暮らす くらす
행복하게::幸せに しあわせに
지역::地域 ちいき
어지르다, 흩뜨리다::散らかす ちらかす
주인이 없는 고양이::野良猫 のらねこ
피해::被害 ひがい
(동물의)똥::フン
숙소::宿 やど
~용::～用 ～よう
저쪽::あっち
그쪽(정중함)::そちら
그쪽::そっち
어느 쪽::どっち
어느 분, 누구(정중함)::どなた
상태::具合 ぐあい
정장, 양복, 슈트::スーツ
~행::～行き ～ゆき
요코하마(지명)::横浜 よこはま
몇, 몇 개, 얼마(수)::いくつ
얼마(금액)::いくら
어느::どの
어느 정도, 얼마나::どのくらい
비용::費用 ひよう
베스트스코어::ベストスコア
볼링::ボーリング
타이타닉::タイタニック
배::船 ふね
지금쯤::今頃 いまごろ
의뢰::依頼 いらい
~경, ~쯤::～頃 ～ごろ
모습::姿 すがた
수색::捜索 そうさく
아니면::それとも
돌연, 갑자기::突然 とつぜん
바라다, 기원하다::願う ねがう
발견되다::見つかる みつかる
틀린 것. 실수::間違い まちがい
딸기::イチゴ
계절::季節 きせつ
추가하다::足す たす
낚다, (낚시로)잡다::釣る つる
~마리::～匹 ～ひき
미리 시간과 장소를 정해서 만나기로 함::待ち合わせ まちあわせ
된장::みそ
더, 다시::もう
한 번 더, 다시 한 번::もう一度 もういちど
아니요::いいえ
초등학생::小学生 しょうがくせい
너무나::あまり
카멜레온::カメレオン
프랑스 사람::フランス人 フランスじん
항구::港 みなと
도움이 되다::役に立つ やくにたつ
통하다::通る とおる
바뀌다::変わる かわる
고장나다, 망가지다::壊れる こわれる
내 기억으로는, 아마::確か たしか
PC::パソコン
기계::機械 きかい
정보::情報 じょうほう
확실한::確かな たしかな
확실히::確かに たしかに
없어지다::なくなる
블로그::ブログ
노약자석::優先席 ゆうせんせき
이상하다, 웃기다::おかしい
이루어지다::叶う かなう
주식::株 かぶ
그러니까::ですから ですから
여러분::皆さん みなさん
아깝다::もったいない
할인::割引 わりびき
좋다::いい
클라리넷::クラリネット
처음(에)::はじめ
처음으로::はじめて
채소가게::八百屋 やおや
기르다::飼う かう
신령님::神様 かみさま
아까, 좀 전에::さっき
맑음(날씨)::晴れ はれ
빛나다::光る ひかる
잘 먹겠습니다::いただきます
어서 ~, ~하세요::どうぞ
대단히, 감사합니다::どうも
고쳐지다, 수리되다::直る なおる
칠하다::塗る ぬる
페인트::ペンキ
꼭::ぜひ
통증::痛み いたみ
꺼지다, 사라지다::消える きえる
신분증::身分証 みぶんしょう
IT::IT(アイティー)
슬프다::悲しい かなしい
기술::技術 ぎじゅつ
퀄리티::クオリティ
성한::盛んな さかんな
산업::産業 さんぎょう
무지, 엄청::すごく
스토리::ストーリー
스피커::スピーカー
민망하다, 부끄럽다::恥ずかしい はずかしい
매우::非常に ひじょうに
다정하다, 상냥하다::優しい やさしい
건물::建物 たてもの
제주도::チェジュド
돼지고기::豚肉 ぶたにく
영국::イギリス イギリス
이탈리아::イタリア
짜증나다::イライラする イライラする
여러 가지의::色々な いろいろな
잘하다::うまい
부럽다::うらやましい
독일::ドイツ
느릇하다, 유유자적하다::のんびりする
프랑스::フランス
여유::余裕 よゆう
그리고, 그리 하여::そうして
그래서::それで
낮잠::昼寝 ひるね
레스토랑::レストラン
베끼다::写す うつす
출장::出張 しゅっちょう
스케줄::スケジュール スケジュール
그럼, 그러면::では
F(학점), 불가::不可 ふか
또는::または
리본::リボン リボン
오스트리아::オーストリア
그들::彼ら かれら
입::口 くち
흐림::曇り くもり
크리스천::クリスチャン
스위스::スイス
그랬더니, 그러자, 그러면, 그렇다면::すると
큰::大きな おおきな
배우::俳優 はいゆう
끈::ひも
여거 가지의::色んな いろんな
경, 쯤::頃 ころ
서포트::サポート
장애::障害 しょうがい
장애인::障害者 しょうがいしゃ
괴롭다::つらい つらい
귀::耳 みみ
유학::留学 りゅうがく
패스워드::パスワード
숲::林 はやし
제일, 가장::一番 いちばん
기간::期間 きかん
속도::速度 そくど
체류, 체재::滞在 たいざい
향하다, 향해 가다::向かう むかう
의외로::意外に いがいに
습격하다::襲う おそう
내려오다, 내리다::下りる おりる
~쪽, ~측::～側 がわ
곰::クマ
이렇게, 이만큼::これほど
세계::世界 せかい
도시::都市 とし
서쪽::西 にし
희귀하다, 드물다::珍しい めずらしい
갈 때, 가는 것::行き いき
휴강::休講 きゅうこう
부재중::留守 るす
가파른::急な きゅうな
서비스::サービス サービス
비탈길::坂 さか
진학::進学 しんがく
이과::理系 りけい
파랗다::青い あおい
신사::神社 じんじゃ
목(인후)::のど
역사::歴史 れきし
열받다::頭に来る あたまにくる
자매::姉妹 しまい
새학기::新学期 しんがっき
높이::高さ たかさ
다다미::畳 たたみ
정중한::丁寧な ていねいな
분위기::雰囲気 ふんいき
베개::枕 まくら
저녁 식사::夕飯 ゆうはん
여관::旅館 りょかん
딱딱하다::硬い かたい
영향::影響 えいきょう
순풍::追い風 おいかぜ
크게::大きく おおきく
~간(사이)::～間 かん
눈치 채다, 알아차리다, 깨닫다::気が付く きがつく
제트기류::ジェット気流 ジェットきりゅう
탓, 때문::せい
서울::ソウル
동쪽::東 ひがし
비행::飛行 ひこう
편서풍::偏西風 へんせいふう
역풍::向かい風 むかいかぜ
단단하다::固い かたい
물건, 물품::品物 しなもの
식품::食品 しょくひん
무엇이든지::何でも なんでも
이르다, 빠르다::早い はやい
햄버그(스테이크)::ハンバーグ
이자카야::居酒屋 いざかや
응대::応対 おうたい
오픈::オープン オープン
마음에 듦, 즐겨찾기::お気に入り おきにいり
안주::おつまみ
카운터::カウンター
장식하다::飾る かざる
퇴근길::仕事帰り しごとがえり
약간 비쌈::高め たかめ
싫어하다::嫌がる いやがる
은퇴::引退 いんたい
장래::将来 しょうらい
지식::知識 ちしき
불안한::不安な ふあんな
죽음::死 し
란도셀(일본 초등학생 책가방)::ランドセル ランドセル
일석이조::一石二鳥 いっせきにちょう
예뻐하다::かわいがる
거꾸로임::逆 ぎゃく
털::毛 け
단열재::断熱材 だんねつざい
그런데, 그러나::ところが
겉보기::見た目 みため
역할::役割 やくわり
미안하다::悪い わるい
강점, 세일즈 포인트::売り うり
가정::家庭 かてい
국제::国際 こくさい
정치::政治 せいじ
아침저녁::朝晩 あさばん
느끼다::感じる かんじる
규칙::規則 きそく
말::言葉 ことば
복도::廊下 ろうか
감동::感動 かんどう
졸업식::卒業式 そつぎょうしき
소중함::大切さ たいせつさ
보물::宝物 たからもの
구조하다, 돕다::助ける たすける
우연히 만나다, 마주치다::出会う であう
(말을 꾸며 줌)::お～
불만::不満 ふまん
지당한::もっともな
대단히 감사합니다::ありがとうございます
급함::急ぎ いそぎ
~ 전체, 온 ~::～中 ～じゅう
퍼지다::広がる ひろがる
여러분(높임)::皆様 みなさま
하다(공손함)::いたす
유행하다::はやる
저런::あんな
역 앞::駅前 えきまえ
처방전::処方せん しょほうせん
생기다::できる
천하태쳥한 성격::のんびり屋 のんびりや
문방구::文房具 ぶんぼうぐ
가게 문을 닫다, 폐업하다::店を閉める みせをしめる
가져가다, 가지고 가다::持っていく もっていく
벽창호::わからず屋 わからずや
왕자::王子 おうじ
끊임없이 노력하는 사람::頑張り屋 がんばりや
극복::克服 こくふく
걸터앉다::腰をかける こしをかける
외로움을 잘 타는 사람::寂しがり屋 さびしがりや
부끄럼쟁이::恥ずかしがり屋 はずかしがりや
방법::方法 ほうほう
보증인::保証人 ほしょうにん
옛날 옛적::昔々 むかしむかし
애처가::愛妻家 あいさいか
작곡::作曲 さっきょく
선, 줄, 금::線 せん
~달::～月 ～つき
천재::天才 てんさい
노력::努力 どりょく
(선, 줄 등을)긋다::引く ひく
페이지, 쪽::ページ ページ
금메달::金メダル きんメダル
나누어 주다::配る くばる
~권::～冊 さつ
~씩::～ずつ
~장::～枚 ～まい
매주::毎週 まいしゅう
겨우::やっと
나누다::分ける わける
그룹::グループ
순서대로::順番に じゅんばんに
주목::注目 ちゅうもく
독서::読書 どくしょ
특징::特徴 とくちょう
발표::発表 はっぴょう
~번째(순서)::～番目 ばんめ
옥상::屋上 おくじょう
바퀴벌레::ゴキブリ
비어가든::ビアガーデン
붙박이장::押し入れ おしいれ
회의실::会議室 かいぎしつ
현관::玄関 げんかん
교외::郊外 こうがい
강당::講堂 こうどう
지하::地下 ちか
뉴욕(지명)::ニューヨーク
후쿠오카(지명)::福岡 ふくおか
이부자리::布団 ふとん
뒤::後ろ うしろ
선반::棚 たな
(편지・서류)봉투::封筒 ふうとう
~자루::～本 ～ほん
사자::ライオン
앞면::表 おもて
쓰레기통::ゴミ箱 ごみばこ
밑, 아래::下 した
매트::マット
한가운데::真ん中 まんなか
단독주택::一戸建て いっこだて
금지::禁止 きんし
빌딩::ビル
맞은편, 건너편::向かい むかい
팁::チップ
홀스태프(매장 직원)::ホールスタッフ
문병 선물::お見舞い おみまい
거울::鏡 かがみ
달력::カレンダー
코트::コート
만년필::万年筆 まんねんひつ
열쇠고리::キーホルダー
축구::サッカー
엽서::葉書 はがき
꽃다발::花束 はなたば
안내서::案内書 あんないしょ
여름에 보내는 선물::お中元 おちゅうげん
속옷::下着 したぎ
직원::職員 しょくいん
드리다::差し上げる さしあげる
팔찌::ブレスレット
주시다::くださる
어드바이스::アドバイス
받다(공손함)::いただく
크리스마스카드::クリスマスカード
아는 사람, 아는 사이::知り合い しりあい
담임::担任 たんにん
작은::小さな ちいさな
(나뭇)가지::枝 えだ
부러뜨리다::折る おる
숨기다::隠す かくす
숨다::隠れる かくれる
끊어지다::切れる きれる
쓰러뜨리다::倒す たおす
더럽히다::汚す よごす
정해지다::決まる きまる
끄다::消す けす
내려가다::下がる さがる
술버릇::酒癖 さけぐせ
폭력::暴力 ぼうりょく
틀리다::間違う まちがう
주변::周り まわり
(술에)취하다::酔う よう
기회::機会 きかい
기타(악기)::ギター
지우개::消しゴム けしゴム
침대::ベッド ベッド
맛::味 あじ
향기::香り かおり
빼앗다::奪う うばう
여자::女 おんな
자라다::育つ そだつ
오한::寒気 さむけ
구역질::吐き気 はきけ
매운 정도::辛さ からさ
콤플렉스::コンプレックス
치과의사::歯医者 はいしゃ
확인::確認 かくにん
댄스스쿨::ダンススクール
허락하다::許す ゆるす
상관없다::構わない かまわない
시대::時代 じだい
자유로운::自由な じゆうな
심하다::ひどい
싫증나다::飽きる あきる
음식점::飲食店 いんしょくてん
과학::科学 かがく
관점::観点 かんてん
기본::基本 きほん
밥집::ご飯屋(さん) ごはんや(さん)
내용::内容 ないよう
뇌::脳 のう
뇌과학::脳科学 のうかがく
패밀리 레스토랑::ファミレス
양식점::洋食屋 ようしょくや
명령하다::命じる めいじる
콘택트렌즈::コンタクト
교복::制服 せいふく
닭고기::とり肉 とりにく
늦잠::寝坊 ねぼう
알람시계::目覚まし時計 めざましどけい
녹차::緑茶 りょくちゃ
스크린::スクリーン
20일::二十日 はつか
파일::ファイル
저장, 보존::保存 ほぞん
호러, 공포::ホラー
부드럽다::軟らかい やわらかい
회원::会員 かいいん
등록::登録 とうろく
사우디아라비아::サウジアラビア
컨디션, 상태::調子 ちょうし
퍼센트::％(パーセント)
파일럿::パイロット
멤버::メンバー
수면::睡眠 すいみん
도로::道路 どうろ
쫓다::追う おう
깨닫다::気づく きづく
시야::視野 しや
보내다, 지내다::過ごす すごす
넓히다::広げる ひろげる
크리스마스 트리::クリスマスツリー
칫솔::歯ブラシ はブラシ
재활용::リサイクル
옮기다::移る うつる
산책::散歩 さんぽ
おおさかじょう공원::大阪城公園 おおさかじょうこうえん
파출소::交番 こうばん
스키::スキー
うえの공원::上野公園 うえのこうえん
효과::効果 こうか
하는 방법::仕方 しかた
다이어트::ダイエット
티켓, 표::チケット
비빔밥::ビビンバ
검색::検索 けんさく
상품::商品 しょうひん
태국::タイ
점점::だんだん
흔들리다::揺れる ゆれる
학자::学者 がくしゃ
희다::白い しろい
유리::ガラス
고장::故障 こしょう
제품::製品 せいひん
아무래도, 어쩐지::どうも
이용::利用 りよう
부자::金持ち かねもち
구워지다::焼ける やける
화장, 메이크업::メイク
암벽 등반::ロッククライミング
안녕하세요(아침 인사)::おはようございます
부딪치다::ぶつかる
문법::文法 ぶんぽう
한 달::ひと月 ひとつき
관광지::観光地 かんこうち
방문하다::訪ねる たずねる
아침식사, 조식::朝食 ちょうしょく
투어::ツアー
개인::個人 こじん
빈틈없이, 확실히::しっかり(と)
평화::平和 へいわ
마침, 꼭::ちょうど
의식::意識 いしき
5일::五日 いつか
금연::禁煙 きんえん
시기::時期 じき
심호흡::深呼吸 しんこきゅう
스타트::スタート
절친::親友 しんゆう
에러::エラー
다운로드::ダウンロード
초인종::チャイム
실제로::実際に じっさいに
그런데도, 그럼에도 불구하고::それなのに
낮, 주간::昼間 ひるま
아무리(~해도)::いくら(～ても)
완전히::完全(に) かんぜん(に)
(사전에서)찾다::引く ひく
도중::途中 とちゅう
립스틱::口紅 くちべに
셰어하우흐::シェアハウス
손수 만든 요리::手料理 てりょうり
멕시코::メキシコ
전쟁::戦争 せんそう
데리다::連れる つれる
테러::テロ
닮다::似る にる
꽤::ずいぶん
(배가)고프다::すく
각각, 각자::それぞれ
빙빙::グルグル
프로펠러::プロペラ
돌다::回る まわる
거실::リビング
조깅::ジョギング
휘트니스클럽::フィットネスクラブ
무역회사::貿易会社 ぼうえき がいしゃ
~정도::～ほど
여배우::女優 じょゆう
쿠키::クッキー
산타클로스::サンタクロース
목도리::マフラー
디저트::デザート
임원::役員 やくいん
용서하다::許す ゆるす
~분, ~치::～分 ～ぶん
효율::効率 こうりつ
자투리, 틈::スキマ
적극적::積極的 せっきょくてき
즉::つまり つまり
군대::軍隊 ぐんたい
전람회::展覧会 てんらんかい
입대::入隊 にゅうたい
일기예보::天気予報 てんきよほう
사이트::サイト
켜지다::つく(電気)
열::熱 ねつ
벨기에::ベルギー
우승::優勝 ゆうしょう
약혼::婚約 こんやく
정직::正直 しょうじき
그대로::そのまま
사귀다::付き合う つきあう
빼다::外す はずす
짝사랑::片思い かたおもい
구(9)::9 きゅう
쇼크::ショック
119번::119番 ひゃく じゅう きゅう ばん
110번(경찰)::110番 ひゃくとおばん
상대::相手 あいて
잘함, 실력::うまさ
가이드, 안내원::ガイド
마늘::にんにく
법률::法律 ほうりつ
기사::記事 きじ
원인::原因 げんいん
취직::就職 しゅうしょく
전문::専門 せんもん
난방::暖房 だんぼう
분야::分野 ぶんや
실례::失礼 しつれい
시간에 대다, 늦지 않게 하다::間に合う まにあう
뮤지컬::ミュージカル
확인하다::確かめる たしかめる
담당자::担当者 たんとうしゃ
인기가 있다(특히 이성에게)::モテる
귀가 잘 안 들리다::耳が遠い みみが とおい
신청::申し込み もうしこみ
넘어지다::転ぶ ころぶ
마라톤::マラソン
(하는)방법::やり方 やりかた
요컨대::要するに ようするに
아프가이스탄::アフガニスタン
콘센트::コンセント
빠지다::抜ける ぬける
좋다, 괜찮다(격식 차린 말투)::よろしい
되도록::なるべく
이집트::エジプト
피부::肌 はだ
찌르다::刺す さす
주인공::主人公 しゅじんこう
마치, 꼭::まるで
피겨스케이팅::フィギュアスケート
코::鼻 はな
미끄러지다::滑る すべる
비행장::飛行場 ひこうじょう
피자::ピザ
케이스::ケース
농담, 조크::ジョーク
의하면::よると
영업부::営業部 えいぎょうぶ
관계::関係 かんけい
비교하다::比べる くらべる
행복::幸せ しあわせ
타인, 남::他人 たにん
이어지다, 연결되다::つながる
만족::満足 まんぞく
인구::人口 じんこう
지리::地理 ちり
도시가스::都市ガス としガス
메이저 리그::メジャーリーグ
인공지능::AI エーアイ
정확한::正確な せいかくな
세로::縦 たて
형편::都合 つごう
인간::人間 にんげん
가로::横 よこ
의학::医学 いがく
서양::西洋 せいよう
동양::東洋 とうよう
8일::8日 ようか
노랑, 노란색::黄色 きいろ
무슨 색::何色 なにいろ
일(일요일)::日(日曜) にち
인터넷 쇼핑::ネットショッピング
부탄::ブータン
초록::緑 みどり
토(토요일)::土(土曜) ど
우주::宇宙 うちゅう
액체::液体 えきたい
음속::音速 おんそく
기체::気体 きたい
광속::光速 こうそく
고체::固体 こたい
전달되다, 전해지다::伝わる つたわる
철, 쇠::鉄 てつ
그런데::ところで
~배::～倍 ～ばい
속도, 빠르기::速さ はやさ
빛::光 ひかり
~초::～秒 ～びょう
초속::秒速 びょうそく
~분의 ~::～分の～ ～ぶんの～
약(대략)::約 やく
하이힐::ハイヒール
당분간, 한 동안::しばらく
바이러스 체크::ウイルスチェック
지나가다::通る とおる
장식::飾り かざり
정월, 설::正月 しょうがつ
난로::ストーブ
엑셀::アクセル
놀이기구::アトラクション
낮::お昼 おひる
브레이크::ブレーキ
(일본식 매실장아찌)::梅干し うめぼし
잔디::芝生 しばふ
신칸센(일본의 고속철도)::新幹線 しんかんせん
마르다::乾く かわく
빨래감, 세탁물::洗濯物 せんたくもの
신경 쓰다::気にする きにする
제출::提出 ていしゅつ
헬멧::ヘルメット
청바지::デニム
치약, 양치질::歯磨き はみがき
새우::エビ
협력::協力 きょうりょく
데이터::データ
튀김::天ぷら てんぷら
외식::外食 がいしょく
빨갛다::赤い あかい
환승::乗り換え のりかえ
스무살::二十歳 はたち
(PC가)다운되다::フリーズする
요즘::この頃 このごろ
갈색::茶色 ちゃいろ
연하장::年賀状 ねんがじょう
포르투갈어::ポルトガル語 ポルトガルご
이벤트::イベント
다음다음 달::再来月 さらいげつ
댐::ダム
파트::パート（タイム）
의장::議長 ぎちょう
학생회장::生徒会長 せいと かいちょう
1일::一日 ついたち
전시회::展示会 てんじかい
이혼::離婚 りこん
실은::実は じつは
수년, 몇 해::すうねん
마음대로, 제멋대로::勝手に かってに
순서::順番 じゅんばん
자세히::細かく こまかく
깎다::負ける まける
계약서::契約書 けいやくしょ
(식사를)대접하다::ご馳走する ごちそうする
먼저::先に さきに
요금::料金 りょうきん
곧장, 곧바로::真っすぐ まっすぐ
붙이다, 묻히다::付ける つける
결코::決して けっして
어쩔 수 없다::仕方がない しかたがない
스위치::スイッチ
샐러드::サラダ
세트::セット
토스트::トースト
패스트푸드::ファーストフード
모닝::モーニング
캐나다::カナダ
연구회::研究会 けんきゅうかい
총리::総理 そうり
대통령::大統領 だいとうりょう
대단히::大変 たいへん
프로젝트::プロジェクト
가시다, 오시다::いらっしゃる
인천::インチョン
가시다, 오시다, 계시다::おいでになる
말씀하시다::おっしゃる
입으시다::お召しになる おめしになる
주무시다::お休みになる おやすみになる
아시다::ご存知だ ごぞんじだ
보시다::ご覧になる ごらんになる
수상::首相 しゅしょう
하시다::なさる
잡수시다::召し上がる めしあがる
임금님::王様 おうさま
첨부::添付 てんぷ
라면::ラーメン
주소::住所 じゅうしょ
보이스피상 사기::フィッシング詐欺 フィッシングさぎ
경주::キョンジュ
가다(공손함), 오다(공손함), 듣다(공손함), 여쭙다, 찾아뵙다::伺う うかがう
뵙다::お目にかかる おめにかかる
보여 드리다::お目にかける おめにかける
알다, 생각하다(공손함)::存じ上げる ぞんじあげる
달::月 つき
보다(공손함)::拝見する はいけんする
빌리다(공손함)::拝借する はいしゃくする
말씀올리다::申し上げる もうしあげる
댁(집)::お宅 おたく
잼::ジャム
저(매우 공손함)::私 わたくし
있다(공손함)::おる
가다, 오다(공손함)::参る まいる
먹다(공손함), 마시다(공손함)::いただく
그러면::それでは
알다(공손함)::存じる ぞんじる
점심(식사)::昼食 ちゅうしょく
번호::番号 ばんごう
보고::報告 ほうこく
반찬::おかず おかず
멋을 냄, 멋쟁이::おしゃれ
주먹밥::おにぎり
쟁반::お盆 おぼん
간식::おやつ
따뜻하게 하다::温かく あたたかく
어떤 자리에서 느끼는 기분::居心地 いごこち
긴장::緊張 きんちょう
그만, 자신도 모르게::つい
급히::取り急ぎ とりいそぎ
오랫동안 있음::長居 ながい
참으로::誠に まことに