횡단::横断おうだん
모퉁이::角かど
비교하다::比べるくらべる
계산::計算けいさん
혈압::血圧けつあつ
건::件けん
현재::現在げんざい
정보::情報じょうほう
싸다, 포장하다::包むつつむ
복수, 둘 이상의 수::複数ふくすう
둥글다::丸いまるい
어렵다, 곤란하다::難しいむずかしい
석양::夕日ゆうひ
유명하다::有名だゆうめいだ
뒤, 뒤쪽::裏うら
과거::過去かこ
슬프다::悲しいかなしい
그립다::恋しいこいしい
호흡::呼吸こきゅう
자연::自然しぜん
증감::増減ぞうげん
주차::駐車ちゅうしゃ
통지::通知つうち
동작::動作どうさ
노력::努力どりょく
도망치다, 달아나다::逃げるにげる
나머지::残りのこり
나다, 나오다, 생겨나다::生えるはえる黴かびの生はえたお餅もち 歯はが生はえている赤あかちゃん
초::秒びょう
우송::郵送ゆうそう
맡기다::預けるあずける
바위::岩いわ
의심하다::疑ううたがう
교류::交流こうりゅう
종류::種類しゅるい
조사::調査ちょうさ
보통, 대개::普通ふつう
부재중::留守るす
늦다::遅いおそい
각 역::各駅かくえき
이기다::勝つかつ
허리::腰こし
고상하다::上品だじょうひんだ
선::線せん
돕다, 살리다::助けるたすける
중식, 점심식사::昼食ちゅうしょく
방위, 방향수단, 방법::方角ほうがく
미래::未来みらい
우편::郵便ゆうびん
예약::予約よやく
젊다::若いわかい
놀다::遊ぶあそぶ
바꾸다::換えるかえる
기계::器械/機械きかい
휴일::休日きゅうじつ
소금::塩しお
제복::制服せいふく
상담, 상의::相談そうだん
졸업::卒業そつぎょう
확실히::確かにたしかに
자신이 있다, 잘하다::得意だとくいだ
부분::部分ぶぶん
명령::命令めいれい
위치::位置いち
밑줄::下線かせん
더럽다::汚いきたない
금연::禁煙きんえん
넘어지다::転ぶころぶ
수술::手術しゅじゅつ
주요하다::主要だしゅようだ
상품::商品しょうひん
조퇴::早退そうたい
직접::直接ちょくせつ
차가워지다, 식다::冷えるひえる
잇다, 연결하다, 매다, 묶다, 맺다::結ぶむすぶ
부러지다, 꺾이다::折れるおれる
관객::観客かんきゃく
공통::共通きょうつう
가하다, 더하다, 보태다::加えるくわえる
훈련::訓練くんれん
개인::個人こじん
세금::税金ぜいきん
도착::到着とうちゃく
내다, 지불하다::払うはらう
방향::方向ほうこう
독립::独立どくりつ
콩::豆まめ
나타내다, 발휘하다::表すあらわす
아름답다::美しいうつくしい
목::首くび
경영학::経営学けいえいがく
혈액형::血液型けつえきがた
지급::支給しきゅう
상상::想像そうぞう
조식, 아침 식사::朝食ちょうしょく
전하다::伝えるつたえる
짐, 화물::荷物にもつ
분류::分類ぶんるい
평균::平均へいきん
변화::変化へんか
말리다, 바닥이 드러나도록 하다::干すほす洗濯せんたく物ものを干ほす池いけの水みずを干ほす
호수::湖みずうみ
상대::相対そうたい
두껍다::厚いあつい
일반적이다::一般的だいっぱんてきだ
응용::応用おうよう
기억하다, 외우다::覚えるおぼえる
바꾸다, 교환하다::替えるかえる
광고::広告こうこく
집중::集中しゅうちゅう
상업::商業しょうぎょう
식기::食器しょっき
대회::大会たいかい
옆, 가로::横よこ
갈라지다, 깨지다::割れるわれる
얕다::浅いあさい
각지::各地かくち
괴롭다, 난처하다, 힘들다::苦しいくるしい
사정::事情じじょう
실력::実力じつりょく
출장::出張しゅっちょう
자리::席せき
선수::選手せんしゅ
저금::貯金ちょきん
문장::文章ぶんしょう
웃다::笑うわらう
땀::汗あせ
이후::以降いこう
웃는 얼굴::笑顔えがお
단단하다, 굳다::固いかたい
완성::完成かんせい
외과::外科げか
곤란하다::困るこまる
섬::島しま
가리키다, 보이다, 나타내다::示すしめす
타인::他人たにん
평일::平日へいじつ
짧다::短いみじかい
늦다, 뒤처지다::遅れるおくれる
접다, 꺾다, 굽히다::折るおる
되돌리다, 돌려주다::返すかえす
가격::価格かかく
의문::疑問ぎもん
단어::単語たんご
지구::地球ちきゅう
발표::発表はっぴょう
표면::表面ひょうめん
깊다::深いふかい
숨::息いき
공석::空席くうせき
짜다::組むくむ
고생::苦労くろう
건, 사항::件けん
실업, 실직::失業しつぎょう
순번, 순서, 차례::順番じゅんばん
통근::通勤つうきん
발견::発見はっけん
부부::夫婦ふうふ
회화, 그림::絵画かいが
기록::記録きろく
칠판::黒板こくばん
들이마시다::吸うすう
확실하다::確かだたしかだ
차가워지다::冷えるひえる
규칙::規則きそく
고가::高価こうか
성격::性格せいかく
전언::伝言でんごん
묵다, 숙박하다::泊まるとまる
딸::娘むすめ
약국::薬局やっきょく
예상::予想よそう
관찰::観察かんさつ
반대, 거꾸로임::逆ぎゃく
울다::泣くなく
낮다::低いひくい
복잡하다::複雑だふくざつだ
나타나다::現れる, 表れるあらわれる
안쪽::内側うちがわ
가구::家具かぐ
반드시, 꼭::必ずかならず
기념::記念きねん
최초::最初さいしょ
정전::停電ていでん
이유::理由りゆう
맞다::当たるあたる
우회전::右折うせつ
귀가::帰宅きたく
주간지::週刊誌しゅうかんし
출근::出勤しゅっきん
퇴원::退院たいいん
열심이다::熱心だねっしんだ
관계::関係かんけい
기대::期待きたい
교사::教師きょうし
경유::経由けいゆ
비탈길, 언덕길::坂道さかみち
두통::頭痛ずつう
다르다, 차이가 있다::違うちがう
날다::飛ぶとぶ
끼다, 꼬다, 짜다::組むくむ腕うでを組くむ 紐ひもを組くむ たんすを組くむ 
승차::乗車じょうしゃ
성적::成績せいせき
파도, 물결::波なみ
잠자다::眠るねむる
빨리::速くはやく
돌리다, 회전시키다, 두르다::回すまわす
만족::満足まんぞく
굽다, 태우다::焼くやく
수출::輸出ゆしゅつ
악기::楽器がっき
빌리다::借りるかりる
관심::関心かんしん
결점::欠点けってん
원인::原因げんいん
근무하다, 종사하다::勤めるつとめる
던지다::投げるなげる
바라다, 원하다::願うねがう
녹색::緑みどり
옮기다, 이동하다::移すうつす
온천::温泉おんせん
결석::欠席けっせき
감소::減少げんしょう
잘다, 작다, 자세하다::細かいこまかい
잡지::雑誌ざっし
빌려주다::貸すかす
잔업::残業ざんぎょう
믿다::信じるしんじる
독신::独身どくしん
도망치다::逃げる
용기, 물건을 담는 그릇::容器ようき
따뜻하게 하다, 데우다::温める、暖めるあたためる
원료::原料げんりょう
자신, 자기, 그 자체::自身じしん
상담, 의논::相談そうだん
키우다, 기르다::育てるそだてる
이, 치아, 이빨::歯は
복습::復習ふくしゅう
아프다::痛いいたい
해결::解決かいけつ
관광::観光かんこう
기온::気温きおん
권, 표::券けん
건강::健康けんこう
자유::自由じゆう
눈물::涙なみだ
법률::法律ほうりつ
좇다, 뒤따르다::追うおう泥棒どろぼうを追おう刑事けいじ 
살다, 생활하다, 지내다::暮らすくらす
혈액::血液けつえき
신장, 키::身長しんちょう
전문가::専門家せんもんか
이야기, 전설::物語ものがたり
지키다, 보호하다::守るまもる
앞지르다, 추월하다::追い越すおいこす
희망::希望きぼう
취소::キャンセル
우연히::偶然ぐうぜん
분하다::悔しいくやしい
자원::資源しげん
얼룩::しみ
친척::親戚しんせき
욱신욱신::ずきずき
등장::登場とうじょう
두근두근::どきどき
꼭 맞는 모양, 딱::ぴったり
짖다::ほえる
레서피, 조리법::レシピ
의지::意志いし
연기, 미룸::延期えんき
수고하십니다, 수고하셨습니다::おつかれさま
효과::効果こうか
재료::材料ざいりょう
세트, 조절::セット
챌린지, 도전::チャレンジ
되도록::なるべく
제각각, 제각기::ばらばら
재잘재잘, 줄줄, 술술::ぺらぺら
보고::報告ほうこく
낭비, 헛됨, 쓸데없음::無駄むだ
아깝다::もったいない
익일, 다음날::翌日よくじつ
하품::あくび
둘러싸다, 에워싸다::取り巻くとりまく
배달::配達はいたつ
비교::比較ひかく
불만, 불평::文句もんく
허둥지둥::うろうろ
간격::間隔かんかく
예술::芸術げいじゅつ
신속한 것, 곧, 즉시::さっそく
친하다, 의좋다::親しいしたしい
농담::冗談じょうだん
청결::清潔せいけつ
적극적::積極的せっきょくてき
통역::通訳つうやく
돌연, 갑자기::突然とつぜん
취소하다::取り消すとりけす
노크::ノック
귀찮다::めんどうくさい
넘치다::溢れるあふれる
의외로::意外にいがいに
에너지::エネルギー
쌓다, 거듭하다::重ねるかさねる
건조::乾燥かんそう
끼다, 고되다::きつい
경영::経営けいえい
꽉, 단단히::しっかり
자동적으로::自動的にじどうてきに
양동이::バケツ
발전::発展はってん
만나기로 하다::待ち合わせるまちあわせる
헤매다, 망설이다, 혹하다::迷うまよう
목표::目標もくひょう
가라앉다, 침착하다::落ち着くおちつく
신청::申請しんせい
꽤, 상당히::ずいぶん
정상이다::正常だせいじょうだ
바닥, 속, 밑::底そこ
꼭 닮음::そっくり
살짝::そっと
매너::マナー
목적::目的もくてき
마루::床ゆか
호소하다::呼び掛けるよびかける
열, 행렬::列れつ
이미지::イメージ
맛있다, 솜씨가 좋다::うまい
와르르, 텅 빈 모양::がらがら屋根やね瓦がわらががらがら(と)崩くずれ落おちる がらがらな[の]客席きゃくせき 
상처, 흠::傷きず
거절하다::断ることわる
가라앉다, 지다::沈むしずむ
의지하다::頼るたよる
특별한 장점::特長とくちょう
내막적으로 함, 집의 안, 부엌::内緒ないしょ
농업::農業のうぎょう
용서하다, 허락하다::許すゆるす
유행하고있다::流行しているりゅうこうしている
향기, 좋은 냄새::香りかおり
감추다, 숨기다::隠すかくす
흥미::興味きょうみ
번창하다, 왕성하다::盛んださかんだ
대표적이다::代表的だだいひょうてきだ
싸우다, 전투하다, 맞서다::戦うたたかう
딱 들어 맞음::ぴったり
방어하다, 막다::防ぐふせぐ
찢어지다, 깨지다, 뚫어지다, 터지다, 다치다, 상처 입다::破れるやぶれる
리사이클, 재활용::リサイクル
요금::料金りょうきん
비율::比例ひりつ
질리다, 싫증나다, 물리다::あきる
구멍::穴あな
축하, 축하선물::お祝いおいわい
참음::我慢がまん
버릇, 습관::くせ
합계::合計ごうけい
깨다, 눈이 뜨이다::覚めるさめる
테마::テーマ
당일::当日とうじつ
팸플릿, 소책자::パンフレット
던지다, 부딪치다, 맞부딪치다::ぶつける
방법::方法ほうほう
나누다, 분배하다::分けるわける
소문::うわさ
따라잡다::追いつくおいつく
이상하다::おかしい
빠지다, 물에 빠지다, 열중하다::おぼれる溺おぼれている人ひとを助たすける 酒色しゅしょくに溺おぼれる 
주로, 대부분::主におもに
마르다, 건조하다, 인간미가 없고 냉담한 느낌을 주다::乾くかわく乾かわいた空気くうき 乾かわいた心こころ 
교환::交換こうかん
자랑::自慢じまん
접다, 개다::畳むたたむ
상태, 컨디션::調子ちょうし
불안::不安ふあん
물가::物価ぶっか
따로따로, 각각::別々べつべつ
응원::応援おうえん
기상하다, 발생하다::起きるおきる
외식::外食がいしょく
실망, 낙담하는 모양::がっかり
한 쪽, 한 짝::片方かたほう
마르다, 시들다::枯れるかれる
차, 차이::差さ
끈질기다, 집요하다::しつこい
대금::代金だいきん
흐름, 물결, 중단::流れながれ
흔들다::振るふる
벗기다, 까다::むく
헤어지다, 작별하다::別れるわかれる
인터뷰::インタビュー
영향::影響えいきょう
커브::カーブ
바싹 마른 모양, 텅 비어 있는 모양::からから
청결하다::清潔だせいけつだ
정리::整理せいり
전후::前後ぜんご
흐르다::流れるながれる
불만::不満ふまん
신청서::申込書もうしこみしょ
환전::両替りょうがえ
취급하다::扱うあつかう
거품::あわ
카탈로그::カタログ
느낌::感じかんじ
감동::感動かんどう
최신::最新さいしん
잠깐, 한동안, 오랫동안::しばらく今いま暫しばらくお待まち下くださいこの問題もんだいは暫しばらく置おいてやあ、暫しばらくだね
묶다, 매다, 결박하다::縛るしばる
체력::体力たいりょく
빨리, 일찌감치::早めにはやめに
반일, 한나절::半日はんにち
집세::家賃やちん
주다::あたえる
주다::あげる
조카::おい
그라운드, 운동장::グラウンド
운동장::運動場うんどうじょう
지정된::指定のしていの
대단히, 몹시, 아주, 퍽, 꽤::ずいぶん
스케줄::スケジュール
예정::予定よてい
쉽게 화내다::すぐ怒るすぐおこる
걱정::心配しんぱい
끝, 마지막::おしまい
끝::終わりおわり
학교를 빼먹고 말았다::学校をサボってしまったがっこう
놀고 싶어서 학교를 쉬고 말았다::遊びたくて学校を休んでしまった
기회::機会きかい
찬스, 기회::チャンス
가지가지, 여러 가지, 다양한::さまざまな
여러 가지::いろいろな
반드시, 꼭, 절대로::絶対にぜったいに
따분하다, 지루하다, 무료하다, 심심하다, 싫증이 나다::退屈だたいくつだ
재미없다::つまらない
납득, 이해::納得なっとく
아주 잘 알았다::とってもよく分かった
만지다, 건드리다::触るさわる
보고하다::報告するほうこくする
통지하다, 알리다::知らせるしらせる
용돈::おこづかい
돈::お金おかね
값, 가격::値段ねだん
조카딸::めい
형제의 딸::兄弟の娘きょうだいのむすめ
간단하다::簡単だかんたんだ
이상한::変なへんな
배가 고프다::お腹がぺこぺこだなか
배가 고프다::お腹がすいているなか
감사::感謝かんしゃ
키친::キッチン
부엌::台所だいどころ
좋지 않은 점::よくないところ
끝내다, 마치다, 완료하다때우다, 해결하다::済ませるすませる
끝내다::終わらせるおわらせる
아무것도 바꾸지 않고::何も変えないで
아무것도 말하지 않고::何も話さないで
달리다::走るはしる
지도하다::指導するしどうする
가르치다::教えるおしえる
수다떨지 말고::しゃべらないで
이야기하지 말고::話さないではなさないで
수단::手段しゅだん
하는 법::やり方やりかた
다소, 약간::多少たしょう
조금, 잠깐, 어지간히::ちょっと
단체로::団体でだんたいで
그룹으로::グループで
트레이닝::トレーニング
연습::練習れんしゅう
유창합니다::ぺらぺらです
가까스로, 간신히, 겨우::やっと
모든, 온갖, 일체의::あらゆる
모든, 전부::すべての
역, 반대::逆ぎゃく
반대::反対はんたい
협력::協力きょうりょく
믿고 있다::信じている
진짜라고 생각하고 있다::本当だと思っている
혼났다, 야단 맞았다::怒鳴られたどなられた
큰 소리로 혼났다::大声で怒られたおおごえ
눈부시다::まぶしい
너무 밝다::明るすぎるあかるすぎる
남았습니다::あまりました
너무 많아서 남았습니다::多すぎて残りました
연기되었다::延期になった
나중에 다른 날에 하게 되었다::後の別の日にやることになった
횡단 금지입니다::横断禁止です
건너서는 안 됩니다::渡ってはいけませんわたっ
빛나다, 빛을 내다, 광택이 있다::光るひかる
실망했다, 피곤해서 맥이 풀렸다::がっかりした
유감스럽게 생각했다::残念だと思った
정해진 바, 규칙::決まりきまり
당연히::当然とうぜん
물론::もちろん
전연, 전혀::全然ぜんぜん
모으다::集めるあつめる
변함없이::相変わらずあいかわらず
전과 같이::前と同じでまえとおなじで
의심하고 있다::疑っている
진짜가 아닌가 하고 생각하고 있다::本当ではないかと思っている
조금씩::少しずつすこしずつ
모두, 전부, 일체, 전체::すべて
전부::全部ぜんぶ
득의양양한, 잘하는, 자신 있는::得意なとくいな
능숙하게 할 수 있는::上手にできるじょうずにできる
배달받았다::配達してもらったはいたつ
당황해서, 허둥대며서둘러::あわてて
서두른 모습으로::急いだようすでいそ
아이디어::アイデア
피로하다::疲れるつかれる
조금 전에::少し前にすこしまえに
지나다, 끝나다, 지나치다::過ぎるすぎる森もりを過すぎる 過すぎた事こと 独善どくぜんに過すぎる 
장소::場所ばしょ
다 팔리다, 매진되다::売り切れるうりきれる
전부 팔리다::全て売れるすべてうれる
요즘::この頃このごろ
최근::最近さいきん
지껄이다, 재잘거리다::しゃべる
이야기하다::話す
확인하다::確かめるたしかめる
주문하다::注文するちゅうもんする
부탁하다, 당부하다, 청하다, 의뢰하다::頼むたのむ
의미, 뜻도리, 사리원인, 사정, 이유::わけ
포기하다, 단념하다::諦めるあきらめる
마음에 드는::気に入っているきにいっ
좋아하는::好きなすきな
공통점::共通点きょうつうてん
같은 점::同じところおなじ
살짝, 가만히, 몰래조금, 좀::そっと
조용히::静かにしずかに
비밀로 하고::内緒にしてないしょ
아무에게도 말하지 않고::誰にも話さないでだれ
연중, 항상, 늘::年中ねんじゅう
항상, 늘::いつも
두렵다, 무섭다겁나다걱정스럽다, 염려스럽다::恐ろしいおそろしい
무섭다::怖いこわい
나쁜 점::悪いところわる
통근하다::通勤するつうきん
적어지다::少なくなるすく
일단 되돌아갔다가 다시 나오다, 다시 하다::出直すでなおす留守るすなので出直でなおす 一いちから出直でなおす 
편하다, 쉽다::楽だらくだ
끝나다::終わるおわる
외우다::覚えるおぼえる
암기하다::暗記するあんき
혼잡하다::混雑しているこんざつ
손님이 많이 있다::客がたくさんいるきゃく
단순하다::単純だたんじゅん
알기 쉽다::分かりやすいわかりやすい
손자::孫まご
딸의 아들::娘の息子
이상하다, 정상이 아니다::異常だいじょうだ
참가::参加さんか
집합::集合しゅうごう
중고::中古ちゅうこ
채워 넣다, 막다, 좁히다::詰めるつめる
견본::見本みほん
알아채다, 깨닫다::気づくきづく
체재, 체류::滞在たいざい
할인::割引わりびき
서로::お互いにたが
뒤섞다::かき混ぜるかきまぜる
발생::発生はっせい
만원::満員まんいん
묻다, 메우다::埋めるうめる
활동::活動かつどう
거리두 장소나 사물 사이의 떨어진 길이::距離きょり
중대함::重大じゅうだい
서로 알게 되다::知り合うしりあう
구별::区別くべつ
건축::建築けんちく
성함, 번창함::盛んさかん
수취하다, 받다::受け取るうけとる
빔, 공, 속이 빔::空から
급함, 갑작스러움::急きゅう
소비::消費しょうひ
굽히다, 구부리다기울어지게 하다::曲げるまげる
어울리다, 잘 맞다::似合うにあう
끓어오름, 비등::沸騰ふっとう
이동하다::移動するいどう
수리::修理しゅうり
신선함, 새롭고 산뜻함::新鮮しんせん
섞다::混ぜるまぜる
데치다, 삶다::ゆでる
기한::期限きげん
쌓이다::たまる
전해지다, 알려지다::伝わるつたわる
고함치다, 호통치다, 야단치다::怒鳴るどなる
내용::内容ないよう
이야기를 걸다, 말을 걸다::話しかけるはなし
떼다, 간격을 벌리다::離すはなす
건설::建設けんせつ
흘리다, 엎지르다::こぼす
진보::進歩しんぽ
쥐다, 잡다, 장악하다::握るにぎる
긴장::緊張きんちょう
방문::訪問ほうもん
번역::翻訳ほんやく
행선지, 목적지::行き先ゆきさき、いきさき
심다::植えるうえる
지시::指示しじ
정직함, 솔직함::正直しょうじき
이제 슬슬::そろそろ
배웅하다::見送るみおくる
느슨하다, 헐렁하다, 허술하다::緩いゆるい
구분하다, 구획 짓다::区切るくぎる
완만함::なだらか
가난하다, 변변찮다::貧しいまずしい
애독::愛読あいどく
청신호::青信号あおしんごう
적신호::赤信号あかしんごう
악의::悪意あくい
악조건::悪条件あくじょうけん
악우, 나쁜 친구::悪友あくゆう
아침 해, 아침 햇살::朝日あさひ
발소리::足音あしおと
발디딜 곳, 토대, 기반::足場あしば
맞음, 명중::当たりあたり
수신인, 수취인, 수신처::あて先あてさき
기름::油あぶら
폭풍::暴風ぼうふう
비밀번호::暗証番号あんしょうばんごう
안정::安定あんてい
의사, 의지, 의욕::意志いし
샘::泉いずみ
아픔::痛みいたみ
한 번::一度いちど
일부, 일부분::一部いちぶ
일부분::一部分いちぶぶん
일류::一流いちりゅう
일생::一生いっしょう
일석이조::一石二鳥いっせきにちょう
일대::一帯いったい
한 잔, 가득::一杯いっぱい
일반::一般いっぱん
이동::移動いどう
이내::以内いない
앉아 졺, 말뚝잠::居眠りいねむり
목숨::命いのち
거실::居間いま
지금쯤::今頃いまごろ
이후, 이래, 앞으로::以来いらい
입구::入り口いりぐち
인쇄::印刷いんさつ
음주::飲酒いんしゅ
수취함, 받음::受け取りうけとり
협의, 미리 상의함::打ち合わせうちあわせ
우주::宇宙うちゅう
안과 겉, 표리::裏表うらおもて
매상::売上うりあげ
품절::売り切れうりきれ
강우량::雨量うりょう
운휴::運休うんきゅう
운임::運賃うんちん
운명::運命うんめい
영원::永遠えいえん
영구::永久えいきゅう
영업::営業えいぎょう
액체::液体えきたい
그림물감::絵の具えのぐ
연설::演説えんぜつ
소풍::遠足えんぞく
연장::延長えんちょう
응대::応対おうたい
왕복::往復おうふく
대형::大型おおがた
깊숙한 곳, 속, 안쪽::奥おく
옥외::屋外おくがい
옥내, 실내::屋内おくない
부모::親おや
뜨거운 물, 더운 물::お湯おゆ
개관::開館かいかん
회사원::会社員かいしゃいん
외출::外出がいしゅつ
해설::解説かいせつ
회담::会談かいだん
개점, 개업::開店かいてん
해답::解答かいとう
회답::回答かいとう
개발::開発かいはつ
회비::会費かいひ
계원, 담당자::係員かかりいん
하계::夏季かき
각자::各自かくじ
각사::各社かくしゃ
학습::学習がくしゅう
각도::角度かくど
확인::確認かくにん
학력::学歴がくれき
가결::可決かけつ
화산::火山かざん
대출::貸出しかしだし
셋집::貸家かしや
개소, 장소, 군데::箇所かしょ
수::数かず
어깨::肩かた
정리, 정돈, 치움::片付けかたづけ
유품, 유물::形見かたみ
편도::片道かたみち
이김, 승리::勝ちかち
외관, 모습, 모양, 꼴볼품, 체면::格好かっこう
각국::各国かっこく
합숙::合宿がっしゅく
활약::活躍かつやく
가입::加入かにゅう
가능::可能かのう
가능성::可能性かのうせい
신::神かみ
머리 모양::髪型かみがた
과목::科目かもく
가죽::皮かわ
생각::考えかんがえ
환경::環境かんきょう
환영회::歓迎会かんげいかい
감탄함, 감복함::感心かんしん
감상::感想かんそう
완주::完走かんそう
관청::官庁かんちょう
관내::館内かんない
관념::観念かんねん
관리::管理かんり
기간::期間きかん
귀국::帰国きこく
기준::基準きじゅん
계절에 걸맞지 않음::季節外れきせつはずれ
기초::基礎きそ
기체::気体きたい
기입::記入きにゅう
기능::機能きのう
손님::客きゃく
휴업::休業きゅうぎょう
급증::急増きゅうぞう
급속, 아주 빠름::急速きゅうそく
휴식::休息きゅうそく
오이::きゅうり
급료, 월급::給料きゅうりょう
교육::教育きょういく
업적::業績ぎょうせき
공동::共同きょうどう
공유::共有きょうゆう
허가::許可きょか
곡::曲きょく
곡선::曲線きょくせん
곡명::曲名きょくめい
의논, 논의, 논쟁, 토론::議論ぎろん
금지::禁止きんし
공항::空港くうこう
풀::草くさ
불평, 불만,푸념과로운 사정, 고충::苦情くじょう
약, 병의 치료제::薬くすり
구체화::具体化ぐたいか
입버릇::口ぐせくちぐせ
조, 반::組くみ
조합::組合くみあい
조장, 반장::組長くみちょう
여러 편으로 가름::組分けくみわけ
구름::雲くも
게시::掲示けいじ
형식::形式けいしき
예능::芸能げいのう
오늘 아침::今朝けさ
경치::景色けしき
결과::結果けっか
결국::結局けっきょく
결혼::結婚けっこん
결심::決心けっしん
결정::決定けってい
결론::結論けつろん
월간지::月刊誌げっかんし
원액::原液げんえき
현역::現役げんえき
원가::原価げんか
한계::限界げんかい
견학::見学けんがく
현금::現金げんきん
현상::現象げんしょう
현대::現代げんだい
한정::限定げんてい
건명::件名けんめい
어휘::ごい
연인, 애인::恋人こいびと
호의::好意こうい
행운::幸運こううん
공원::公園こうえん
강연::講演こうえん
후원::後援こうえん
합격::合格ごうかく
고학력::高学歴こうがくれき
공공::公共こうきょう
교제::交際こうさい
교차로::交差点こうさてん
강사::講師こうし
공사::工事こうじ
공식::公式こうしき
공장::工場こうじょう, こうば
공정::公正こうせい
교체, 교대::交代こうたい
교체::交替こうたい
교통::交通こうつう
행동::行動こうどう
후배::後輩こうはい
행복::幸福こうふく
공무::公務こうむ
목소리::声こえ
얼음::氷こおり
소형::小型こがた
국제::国際こくさい
국민::国民こくみん
걸상, 의자::腰掛けこしかけ
고체::固体こたい
국회::国会こっかい
골절::骨折こっせつ
용돈::小遣いこづかい
소포::小包こづつみ
좋아함, 기호::好みこのみ
개별::個別こべつ
쓰레기통::ゴミ箱ゴミばこ
밀::小麦こむぎ
밀가루::小麦粉こむぎこ
미안함, 용서함::ご免ごめん
보심::ご覧ごらん
약혼::婚約こんやく
때, 기회, 경우::際さい
재개::再開さいかい
재회::再会さいかい
최고::最高さいこう
최종::最終さいしゅう
최다::最多さいた
최대::最大さいだい
최저::最低さいてい
재능::才能さいのう
재이용::再利用さいりよう
작업::作業さぎょう
어제::昨日さくじつ、きのう
작성::作成さくせい
작년::昨年さくねん
작품::作品さくひん
벚꽃, 벚나무::桜さくら
술::酒さけ
좌석::座席ざせき
작곡::作曲さっきょく
좌우, 좌지우지::左右さゆう
차별::差別さべつ
예의범절::作法さほう
작용::作用さよう
참고::参考さんこう
산수::算数さんすう
산지::産地さんち
산정::算定さんてい
유감스러움::残念ざんねん
자격::資格しかく
수업 시간표, 예정표, 시간 할당표::時間割じかんわり
식::式しき
식장::式場しきじょう
사건::事件じけん
시각, 시간::時刻じこく
지진::地震じしん
시읍면::市町村しちょうそん
실현::実現じつげん
실험::実験じっけん
실행::実行じっこう
실제::実際じっさい
실적::実績じっせき
실내::室内しつない
실패, 실수::失敗しっぱい
지정::指定してい
자전::自転じてん
자동::自動じどう
자동판매기::自動販売機じどうはんばいき
지배::支配しはい
지불하다, 지급하다, 치르다::支払うしはらう
이비과::耳鼻科じびか
사망::死亡しぼう
시보::時報じほう
섬나라::島国しまぐに
성명::氏名しめい
사원::社員さゃいん
약점::弱点じゃくてん
차내::車内しゃない
사고::事故じこ
주위::周囲しゅうい
습관, 관습::習慣しゅうかん
수집::収集しゅうしゅう
주택::住宅じゅうたく
집단::集団しゅうだん
충전::充電じゅうでん
주말::週末しゅうまつ
주민::住民じゅうみん
중역::重役じゅうやく
종료::終了しゅうりょう
중량::重量じゅうりょう
기숙사::塾じゅく
숙박::宿泊しゅくはく
수험::受験じゅけん
출신::出身しゅっしん
출석::出席しゅっせき
출판::出版しゅっぱん
취득::取得しゅとく
수명::寿命じゅみょう
주역::主役しゅやく
순서, 차례::順じゅん
사용::使用しよう
장학금::奨学金しょうがくきん
초등학생::小学生しょうがくせい
승객::乗客じょうきゃく
상급::上級じょうきゅう
조건::条件じょうけん
상사, 상급 관청::上司じょうし
소수::小数しょうすう
소수점::小数点しょうすうてん
상태::状態じょうたい
소아, 어린이::小児しょうに
증명::証明しょうめい
정면::正面しょうめん
장래::将来しょうらい
여왕::女王じょおう
초회, 첫 번::初回しょかい
직원::職員しょくいん
직업::職業しょくぎょう
직장::職場しょくば
식욕::食欲しょくよく
처리::処理しょり
서류::書類しょるい
아는 사람, 아는 사이::知り合いしりあい
사립::私立しりつ
진학::進学しんがく
신학기::新学期しんがっき
신간센::新幹線しんかんせん
신규::新規しんき
신호::信号しんごう
인종::人種じんしゅ
신춘, 신년::新春しんしゅん
인생::人生じんせい
친족, 친척::親族しんぞく
신체, 몸::身体しんたい
진단::診断しんだん
신입, 신참::新入しんにゅう
신입 사원::新入社員しんにゅうしゃいん
신입생::新入生しんにゅうせい
신년::新年しんねん
신년회::新年会しんねんかい
신용::信用しんよう
진로::進路しんろ
수온::水温すいおん
추천::推薦すいせん
숫자::数字すうじ
수식, 겉모양을 꾸밈::修飾しゅうしょく
몇 사람, 수명::数人すうにん
수년, 몇 년, 여러 해::数年すうねん
초밥::すし
주거, 삶, 살고 있는 집::住まいすまい
탓, 원인, 이유::せい
성과::成果せいか
생활::生活せいかつ
성공::成功せいこう
생산::生産せいさん
정치::政治せいじ
생존::生存せいぞん
성장::成長せいちょう
제도::制度せいど
청년::青年せいねん
성능::性能せいのう
정부::政府せいふ
생물::生物せいぶつ
성분::成分せいぶん
성별::性別せいべつ
생명::生命せいめい
정문::正門せいもん
책임::責任せきにん
접속::接続せつぞく
접대::接待せったい
절약::節約せつやく
등::背中せなか
전원::全員ぜんいん
전과, 모든 과목::全課ぜんか
전과, 전교과, 전학과::全科ぜんか
전회, 회원 전체::全会ぜんかい
전날::前日ぜんじつ
전일, 하루 종일::全日ぜんじつ
전집::全集ぜんしゅう
전신::全身ぜんしん
전체::全体ぜんたい
세탁, 빨래::洗濯せんたく
선택::選択せんたく
선정::選定せんてい
선전::宣伝せんでん
미국 전국::全米ぜんべい
증가::増加ぞうか
상정::想定そうてい
속도::速度そくど
속력::速力そくりょく
메밀국수::そば
할아버지::祖父そふ
각자, 제각기::それぞれそれぞれ違ちがう仕事しごとをしている
존재::存在そんざい
대응::対応たいおう
체온::体温たいおん
퇴직::退職たいしょく
대표::代表だいひょう
제목::題名だいめい
태양, 해::太陽たいよう
대륙::大陸たいりく
대립::対立たいりつ
다수::多数たすう
다수결::多数決たすうけつ
다다미::畳たたみ
탁구::卓球たっきゅう
달성::達成たっせい
계곡::谷たに
씨앗, 원인::種たね
부탁::頼みたのみ
다발, 뭉치, 묶음::束たば
때, 번, 횟수::度たび
알, 달걀::卵たまご
한숨::ため息ためいき
단위::単位たんい
단가::単価たんか
단점::短所たんしょ
단색::単色たんしょく
단신::単身たんしん
단수::単数たんすう
남성::男性だんせい
단정::断定だんてい
담당::担当たんとう
담임::担任たんにん
땅::地ち
지위::地位ちい
차이, 틀림::違いちがい
중학::中学ちゅうがく
중학생::中学生ちゅうがくせい
중형::中型ちゅうがた
중간::中間ちゅうかん
중국::中国ちゅうごく
중심::中心ちゅうしん
중성::中性ちゅうせい
중독::中毒ちゅうどく
중년::中年ちゅうねん
주목::注目ちゅうもく
중립::中立ちゅうりつ
초과::超過ちょうか
조간::朝刊ちょうかん
주차장::駐車場ちゅうしゃじょう
장점::長所ちょうしょ
통학::通学つうがく
통행::通行つうこう
통상::通常つうじょう
통신::通信つうしん
통용::通用つうよう
한 번 쓰고 버림::使い捨てつかいすて
책상::机つくえ
사귐, 교제::付き合いつきあい
다른 일과의 관계, 형편, 사정::都合つごう
싼 물건, 보따리::包みつつみ
이음, 막간::つなぎ
수당::手当てあて
정기::定期ていき
정지::停止ていし
정차::停車ていしゃ
정도::程度ていど
손끝, 바로 눈앞::手先てさき
수속, 절차::手続き/手続てつづき
품, 수고, 노력::手間てま
하늘, 천::天てん
전자식 탁상 계산기::電卓でんたく
전지, 건전지::電池でんち
천연::天然てんねん
튀김::天ぷらてんぷら
물음, 질문::問いとい
동계::冬季とうき
도산::倒産とうさん
동시::同時どうじ
동창회::同窓会どうそうかい
도로::道路どうろ
이익, 이득::得とく
특이::特異とくい
독서::読書どくしょ
특성::特性とくせい
특징::特徴とくちょう
특정::特定とくてい
득점::得点とくてん
특유::特有とくゆう
도시::都市とし
도서관::図書館としょかん
늙은이, 노인::年寄りとしより
토대, 기초, 대::土台どだい
땅, 토지, 그 지방::土地とち
도보::徒歩とほ
묵음, 숙박::泊まりとまり
내과::内科ないか
장수::長生きながいき
화해::仲直りなかなおり
여러 해, 긴 세월, 오랜 동안::長年ながねん
절반, 중간::半ばなかば
동료, 동아리::仲間なかま
알맹이, 내용::中身、中味なかみ
전망, 경치::ながめ
가로수::並木なみき
서투름, 대하기 싫은 상대, 잘 못함, 어색함::苦手にがて
육친::肉親にくしん
일시, 날짜::日時にちじ
일간지::日刊紙にっかんし
일과::日課にっか
일정::日程にってい
두 배::二倍にばい
입대::入隊にゅうたい
입력::入力にゅうりょく
인기::人気にんき
인간::人間にんげん
인원수::人数にんずう
바람, 부탁, 원하는 바::願いねがい
연도::年度ねんど
연령, 나이::年齢ねんれい
능력::能力のうりょく
뒤, 후::のち
풀, 끈끈한 물질::のり
타고 가다 목적지를 지나침::乗り越しのりこし
배분::配分はいぶん
상자::箱はこ
빗나감::外れはずれ
발간::発刊はっかん
발행::発行はっこう
발상::発想はっそう
발송::発送はっそう
발매::発売はつばい
발명::発明はつめい
꽃다발::花束はなたば
불꽃, 폭죽::花火はなび
장면::場面ばめん
일찍 일어남::早起きはやおき
장미::ばら
바늘::針はり
반음::半音はんおん
반액::半額はんがく
반성::反省はんせい
반 년::半年はんとし、はんねん
판매::販売はんばい
반쪽 면, 반면, 다른 한 면::半面はんめん
반면, 한편::反面はんめん
순서, 순번, 차례::番ばん
피해::被害ひがい
당일치기::日帰りひがえり
빛::光ひかり
광통신::光通信ひかりつうしん
광전기::光電気ひかりでんき
비서::秘書ひしょ
미인::美人びじん
필요함::必要ひつよう
집게손가락::人差し指ひとさしゆび
하룻밤::一晩ひとばん
독신 생활, 혼자살기::一人暮らしひとりぐらし
비밀::秘密ひみつ
끈::紐ひも
비용::費用ひよう
미용::美容びよう
우박::ひょう
평가::評価ひょうか
표현::表現ひょうげん
표시::表示ひょうじ
낮잠::昼寝ひるね
풍경::風景ふうけい
부부 싸움::夫婦げんか
부하::部下ぶか
부근::付近ふきん
복지::福祉ふくし
복장::服装ふくそう
부인, 여성::婦人ふじん
무사함::無事ぶじ
뚜껑, 덮개::ふた
평소, 일상::普段ふだん
이불, 요::布団ふとん
부품::部品ぶひん
눈보라::吹雪ふぶき
불평::不評ふひょう
불명::不明ふめい
분수, 몫, 부분::分ぶん
분해::分解ぶんかい
문방구::文房具ぶんぼうぐ
분야::分野ぶんや
분량::分量ぶんりょう
미국::米国べいこく
폐점::閉店へいてん
변경::変更へんこう
변소::便所べんじょ
반신, 답서, 회신::返信へんしん
무역::貿易ぼうえき
방언::方言ほうげん
방침::方針ほうしん
망년, 그 해의 괴로움을 잊음::忘年ぼうねん
망년회, 송년회::忘年会ぼうねんかい
방면::方面ほうめん
보건::保健ほけん
별::星ほし
보존, 저장::保存ほぞん
뼈, 가시::骨ほね
본식, 정식::本式ほんしき
본일, 금일, 오늘::本日ほんじつ
본인::本人ほんにん
매번::毎度まいど
앞머리::前髪まえがみ
선금::前金まえきん
짐, 패배::負けまけ
창문::窓まど
창구::窓口まどぐち
만일::万一まんいち
만에 하나::万が一まんがいち
만점::満点まんてん
몸, 신체::身み
맞선::見合みあい
외관, 겉보기::見かけみかけ
보기, 견해, 생각::見方みかた
자기 편, 아군::味方みかた
된장::味噌みそ
표제어, 제목, 헤드라인::見出しみだし
미정::未定みてい
열매를 맺음, 결실, 소득, 성과::実りみのり
서울, 도읍::都みやこ
성씨, 성::名字みょうじ
민가::民家みんか
무, 헛됨::無む無むから有ゆうを生しょうずるせっかくの好意こうい[努力どりょく]が無むになる
마주 봄, 정면, 건너편, 맞은편::向かいむかい
옛날::昔むかし
무효::無効むこう
벌레::虫むし
무명::無名むめい
무료::無料むりょう
명산품::名産品めいさんひん
명사::名詞めいし
명함::名刺めいし
면회::面会めんかい
면허::免許めんきょ
면접::面接めんせつ
신청, 제의::申し出もうしで
모포, 담요::毛布もうふ
문자::文字もじ
물건과 일, 모든 일::物事ものごと
자, 척도, 기준, 표준::物差しものさし
가장 가까움, 근처::最寄りもより最寄もよりの駅えきを探さがす 
문::門もん
임무, 역할::役目やくめ
역할, 임무::役割やくわり
숙소, 여관::宿やど
여관::宿屋やどや
지붕::屋根やね
유일::唯一ゆいいつ
우승::優勝ゆうしょう
저녁밥, 저녁 식사::夕食ゆうしょく
유료::有料ゆうりょう
행방::行方ゆくえ
수입량::輸入量ゆにゅうりょう
손가락, 발가락::指ゆび
용암::溶岩ようがん
용구, 도구::用具ようぐ
용건::用件ようけん
용지::用紙ようし
용도::用途ようと
요일::曜日ようび
용품::用品ようひん
용법::用法ようほう
예금::預金よきん
익월, 다음 달::翌月よくげつ
욕심이 많음::欲張りよくばり
더러움::汚れよごれ
예산::予算よさん
딴 곳, 타처::よそ余所よその国くに余所よその子こ
밤중, 한밤중::夜中よなか
내일, 외국인이 일본에 옴::来日らいにち
낙선::落選らくせん
낙제::落第らくだい
이과::理科りか
이해::理解りかい
유학::留学りゅうがく
양국::両国りょうこく
영수::領収りょうしゅう
양친, 부모::両親りょうしん
기숙사비::寮費りょうひ
좋은 친구::良友りょうゆう
빈 집을 지킴, 집보기::留守番るすばん
예, 늘, 여느::例れい
예외::例外れいがい
예의::礼儀れいぎ
역사::歴史れきし
열차::列車れっしゃ
열도::列島れっとう
연애::恋愛れんあい
연휴::連休れんきゅう
연속::連続れんぞく
노인::老人ろうじん
노동::労働ろうどう
녹음::録音ろくおん
논문::論文ろんぶん
젊은이, 청년::若者わかもの
헤어짐, 이별::別れわかれ
고추냉이::わさび
각자 부담::割り勘わりかん
우리들::我々われわれ
사랑하다::愛するあいする
틈, 시간을 내다::空けるあける
맡다, 보관하다::預かるあずかる
훈훈해지다::暖まる, 温まるあたたまる
들어맞다, 적합하다::当てはまるあてはまる
말을 되받다::言い返すいいかえす
자르기 시작하다, 잘라 내어 반출하다, 말을 꺼내다::切り出すきりだす
괴롭히다::いじめる
아프다, 괴롭다::痛むいたむ
상하다, 파손되다::傷むいたむ
붙다, 합격하다::受かるうかる
뜨다::浮くうく
움직이다, 옮기다::動かすうごかす
잃어버리다, 놓치다::失ううしなう
미리 상의하다::打ち合わせるうちあわせる
비치다, 영상이 나타나다::映るうつる
수긍하다, 고개를 끄덕이다::うなずく
부러워하다::うらやむ
얻다::得るえる
응하다, 따르다::応じる、応ずるおう
보내다, 선사하다, 주다, 선물하다::贈るおくる
가르침을 받다, 배우다::教わるおそわる
생각되다::思えるおもえる
헤엄치다, 수영하다::泳ぐおよぐ
이지러지다, 빠지다, 없다, 결여하다::欠けるかける
포개지다, 겹치다::重なるかさなる
기울다::傾くかたむく
말하다, 이야기하다::語るかたる
말리다, 건조하다::乾かすかわかす
느끼다::感じるかんじる
관하다::関するかんする
갈아입다::着替えるきがえる
상처를 입히다::傷付けるきずつける
눈치채다, 깨닫다::気付くきづく
정해지다, 결정되다, 일정해지다::定まるさだまる
정하다, 결정하다, 제정하다::定めるさだめる行ゆく先さきも定さだめぬ旅たび 法ほうで定さだめられた労働ろうどう時間じかん 
되풀이하다::繰り返すくりかえす
깎다, 삭감하다, 없애다::削るけずる
걸터앉다::腰掛けるこしかける
다르다, 같지 않다, 상이하다::異なることなる
해치우다, 능숙하게 다루다::こなす
넘쳐 흐르다::こぼれる
죽이다::殺すころす
꽃피다::咲くさく
가리키다, 지목하다::指すさす
따르다, 복종하다, 모방하다::従うしたがう
지배하다::支配するしはいする
지불하다, 치르다::支払うしはらう
마비되다, 저리다::しびれる
마감하다::締め切るしめきる
차지하다::占めるしめる
수다를 떨다, 이야기하다::さゃべる
뛰어나다, 우수하다::優れるすぐれる
진척시키다::進めるすすめる
추천하다::薦めるすすめる
앉다::座るすわる
접하다::接するせっする
공격하다::攻めるせめる
자라다, 성장하다::育つそだつ
대하다::対するたいする
높이다::高めるたかめる
살아나다, 구조되다, 해를 입지 않다, 편해지다::助かるたすかる危あやうく助たすかる 留守るす中ちゅうに泥棒どろぼうが入はいったが宝石ほうせきは助たすかった 費用ひようが助たすかる 
달하다, 이르다, 도달하다::達するたっする
예를 들다, 비유하다::例えるたとえる
사귀다, 교재하다::付き合うつきあう
이어지다, 연결되다::つながる
생기다, 다 되다, 만들어지다, 할 수 있다::できる
풀다, 개봉하다::解くとく
닿다, 도착하다, 이르다::届くとどく
뛰다, 도약하다::跳ぶとぶ
받아들이다, 도입하다::取り入れるとりいれる
고치다, 치료하다::治すなおす
흘리다, 떠내려 보내다::流すながす
이름짓다::名付けるなづける
고민하다::悩むなやむ
성립하다::成り立つなりたつ
익숙해지다, 사람을 따르다::慣れるなれる
남기다::残すのこす
남다::余るあまる
위에 놓다, 싣다::載せるのせる
늘다, 자라다, 발전하다, 신장하다::伸びるのびる
길어지다, 연장되다, 늘어나다, 탄력이 없어지다::延びるのびる
실리다::載るのる
배달하다::配達するはいたつする
우습게 보이다, 시시하다, 말 같잖다::ばかげる馬鹿ばかげた話はなしだ 
빠지다, 벗어나다, 제외되다::外れるはずれる
서로 이야기하다::話し合うはなしあう
놓다, 풀어 놓다::放すはなす
없애다, 줄이다, 생략하다::省くはぶく
불입하다::払い込むはらいこむ
반하다::反するはんする
끌다, 끌어당기다::引っ張るひっぱる
차게 하다, 식히다::冷やすひやす
넓어지다, 확대되다::広がるひろがる
부딪치다, 마주치다, 부닥치다::ぶつかる電柱でんちゅうにぶつかる
줄이다, 덜다::減らすへらす
열매를 맞다, 여물다::実るみのる
맞이하다::迎えるむかえる
마주 보다, 상대하다::向き合うむきあう
향하다::向くむく
신청하다::申し込むもうしこむ
가지고 다니다::持ち歩くもちあるく
집애 싸가지고 가다::持ち帰るもちかえる
쉬게 하다, 휴식시키다::休めるやすめる
그만두다, 사직하다, 사임하다::辞めるやめる
지다, 패배하다::敗れるやぶれる
꿈을 꾸다::夢見るゆめみる
논하다::論じる、するろん
갈리다, 나뉘다, 구별되다::分かれるわかれる
달콤하다, 엄하지 않다::甘いあまい
수상하다, 의심스럽다::怪しいあやしい
감사하다, 고맙다::ありがたい
바쁘다::忙しいいそがしい
부럽다, 샘이 나다::うらやましい
훌륭하다, 심하다::偉いえらい
참을성 있다::我慢強いがまんづよい
귀엽다, 사랑스럽다::かわいらしい
고약한 냄새가 나다, 구리다::臭いくさい
험하다, 험악하다, 험상궂다::険しいけわしい
짙다, 진하다, 빽빽하다::濃いこい
날카롭다, 예리하다::鋭いするどい
당치않다::とんでもない
심하다, 격렬하다::激しいはげしい
오래다::久しいひさしい
가늘다, 좁다::細いほそい
좋다::良いよい
분명하다, 명백하다::明らかだあきらかだ
당연하다::あたりまえだ
의외이다::意外だいがいだ
위대하다::偉大だいだいだ
귀중하다::貴重だきちょうだ
거대하다::巨大だきょだいだ
개인적이다::個人的だこじんてきだ
여러 가지이다::様々ださまざまだ
행복하다::幸せだしやわせだ
중요하다::重要だじゅうようだ
순조롭다::順調だじゅんちょうだ
정직하다::正直だしょうじきだ
멋지다::すてきだ
순진하다, 솔직하다::素直だすなおだ
전국적이다::全国的だぜんこくてきだ
전면적이다::全面的だぜんめんてきだ
확실하다, 정확하다::たしかだ
같은 모양이다, 다름없다::同様だどうようだ
화려하다::派手だはてだ
짓궃음, 얄궃음, 빈정거림::皮肉ひにく
불가사의하다, 이상하다::不思議だふしぎだ
부분적이다::部分的だぶぶんてきだ
평화롭다::平和だへいわだ
드물다, 희소하다::まれだ近年きんねん稀まれな暑あつさ
열중하다, 몰두하다::夢中だむちゅうだ夢中むちゅうで本ほんを読よんだ
무용, 쓸데없다, 필요없다, 해서는 안된다::無用だむようだ
명확하다::明確だめいかくだ
유효하다::有効だゆうこうだ
쓸데없다, 불필요하다, 지나치다, 무익하다::余計だよけいだ
뜻밖에도, 의외로, 예상 외로::案外あんがい
갑자기::いきなり
일일이, 하나하나::いちいち
일시에, 한꺼번에::一度にいちどに
지금도, 현재도::今でもいまでも
마음껏::思い切り、思いっきりおも、き
각별, 특별, 별로::格別かくべつ
제법, 꽤, 상당히, 어지간히::かなり
깔끔히, 정확히, 규칙 바르게::きちんときちんとした身みなり 時間じかんをきちんと守まもる きちんとした生活せいかつ 
반대로, 거꾸로::逆にぎゃくに
흔들흔들, 근들근들::ぐらぐら
실로::実にじつに
실은, 사실은::実はじつは
자주, 여러 번, 누차, 종종::しばしばしばしば会あう人ひと
적어도::少なくともすくなくとも
굉장히::すごく
조금도::少しもすこしも
자진하여::進んですすんで
모처럼::せっかく
적어도, 하다못해, 굳이::せめて
서두르는 모양, 부랴부랴::そうそう
상당히::相当そうとう
속속, 잇달아, 끊임없이::続々(と)ぞくぞく
단정하게, 확실히, 충분히::ちゃんとちゃんとした服装ふくそう仕事しごとをちゃんと済すますちゃんと知しってるぞ
늘, 항상::常につねに
결국, 즉, 요컨대::つまり
점점이::点々てんてん
왈칵, 왁자글, 우르르::どっと
하여간, 어쨌든, 좌우간::とにかく
다 같이, 함께, 동시에, 또::共にともに
어째서, 왜, 무슨 이유로::何でなんで
무엇이든지::何でもなんでも
생긋생긋, 싱글벙글, 생글생글::にこにこ
한가로이, 유유히, 느긋함, 태평함::のんびり
뿔뿔이::ばらばら
비교적::比較的ひかくてき
번쩍번쩍::ぴかぴか
거의, 대부분, 대개, 대강::ほぼ
그저 그런 정도임, 그런대로::まあまあ
물론::もちろん
기꺼이::喜んでよろこんで
두근두근, 울렁울렁::わくわく
고수입::高収入こうしゅうにゅう
고성능::高性能こうせいのう
재사용::再使用さいしよう
재제출::再提出さいていしゅつ
재이용::再利用さいりよう
제이, 두 번째::第二だいに
제삼, 세 번째::第三だいさん
단기간::短期間たんきかん
단거리::短距離たんきょり
단시간::短時間たんじかん
장시간::長時間ちょうじかん
장거리::長距離ちょうきょり
장기간::長期間ちょうきかん
불완전::不完全ふかんぜん
불규칙::不規則ふきそく
불필요함::不必要ふひつよう
매회::毎回まいかい
매 토요일::毎土曜まいどよう
매년도::毎年度まいねんど
무의미::無意味むいみ
무득점::無得点むとくてん
명연설::名演説めいえんぜつ
명산지::名産地めいさんち
명장면::名場面めいばめん
다음날 아침::翌朝よくあさ
다음 영업일::翌営業日よくえいぎょうび
다음 월요일::翌月曜よくげつよく
응원가::応援歌おうえんか
주제가::主題歌しゅだいか
유행가::流行歌りゅうこうか
경리과::経理課けいりか
교통안전과::交通安全課こうつうあんぜんか
인사과::人事課じんじか
가정과::家庭科かていか
사회과::社会科しゃかいか
소아과::小児科しょうにか
국제화::国際化こくさいか
자유화::自由化じゆうか
파손 개소::破損箇所はそんかしょ
형제간::兄弟間きょうだいかん
부부간::夫婦間ふうふかん
사명감::使命感しめいかん
책임감::責任感せきにんかん
만족감::満足感まんぞくかん
사진관::写真館しゃしんかん
미술관::美術館びじゅつかん
산란기::産卵期さんらんき
소년기::少年期しょうねんき
청년기::青年期せいねんき
전화국::電話局でんわきょく
라디오국::ラジオ局きょく
나이 어린 패::年少組ねんしょうぐみ
나이 많은 패::年長組ねんちょうぐみ
낙제생 패::落第組らくだいぐみ
승차권::乗車券じょうしゃけん
입장권::入場券にゅうじょうけん
할인권::割引券わりびきけん
가와구치호::河口湖かわぐちこ
사가미호::相模湖さがみこ
비와호::琵琶湖びわこ
소비세 포함::消費税込みしょうひぜいこみ
세금 포함::税込みぜいこみ
송료 포함::送料込みそうりょうこみ
돌아가실 때::お帰りの際おかえりのさい
이때::この際このさい
비상인 때::非常の際ひじょうのさい
출장처::出張先しゅっちょうさき
근무처, 직장::勤め先つとめさき
연락처::連絡先れんらくさき
시험지::試験紙しけんし
신문지::新聞紙しんぶんし
포장지::包装紙ほうそうし
신문사::新聞社しんぶんしゃ
적십자사::赤十字社せきじゅうじしゃ
여행사::旅行社りょこうしゃ
증명서::証明書しょうめいしょ
영수증::領収書りょうしゅうしょ
스키장::スキー場じょう
셋집살이::貸家住まいかしやずまい
여관살이::宿屋住まいやどやずまい
시골살이::田舎住まいいなかずまい
안전성::安全性あんぜんせい
위험성::危険性きけんせい
화산대::火山帯かざんたい
시간대::時間帯じかんたい
지진대::地震帯じしんたい
학교장::学校長がっこうちょう
경찰서장::警察署長けいさつしょちょう
지점장::支店長してんちょう
사진첩::写真帳しゃしんちょう
일기장::日記帳にっきちょう
메모장::メモ帳ちょう
영화통::映画通えいがつう
경제통::経済通けいざいつう
정보통::情報通じょうほうつう
식료품점::食料品店しょくりょうひんてん
판매점::販売店はんばいてん
요리점::料理店りょうりてん
북해도::北海道ほっかいどう
참가비::参加費さんかひ
주택비::住宅費じゅうたくひ
생활비::生活費せいかつひ
기념일::記念日きねんび
희망일::希望日きぼうび
출발일::出発日しゅっぱつび
귀중품::貴重品きちょうひん
기념품::記念品きねんひん
불량품::不良品ふりょうひん
영업부::営業部えいぎょうぶ
몇 부::何部なんぶ
오사카부::大阪府おおさかふ
교토부::京都府きょうとふ
한달치::一箇月分いっかげつぶん
인원수분::人数分にんずうぶん
부족분::不足分ふそくぶん
일반용::一般向けいっぱんむけ
어린이용::子供向けこどもむけ
신학기용::新学期向けしんがっきむけ
학교명::学校名がっこうめい
과목명::科目名かもくめい
여행명::旅行名りょうこうめい
차멀미::車酔いくるまよい
숙취::二日酔いふつかよい
뱃멀미::船酔いふなよい
공업용::工業用こうぎょうよう
산책용::散歩用さんぽよう
수영용::水泳用すいえいよう
적재량::積載量せきさいりょう
수출량::輸出量ゆしゅつりょう
서로 돕다::助け合うたすけあう
고쳐 만들다::作り変えるつくりかえる
및::および
따라서::したがって
게다가, 더구나, 또한::そのうえ
그런데도, 그래도::それでも
그런데도::それなのに
그렇다면, 그러면::それなら
그러나, 그렇지만::だが
그러니까::ですから
그런데, 그건 그렇고::ところで
왜냐하면::なぜなら
신세를 지다::お世話になるおせわになる
마음이 무겁다::気が重いきがおもい
깨닫다, 주의가 미치다, 의식이 돌아오다::気がつくきがつく間違まちがいに気きが付つく よく気きが付つく人ひと 気きが付ついたら病院びょういんのベッドの上うえだった 
성질이 급하다::気が短いきがみじかい
걱정하다, 신경쓰다::気にするきにする
신경쓰이다::気になるきになる
입이 가볍다::口が軽いくちがかるい
습관을 들이다::習慣をつけるしゅうかんをつける
손에 넣다, 손에 들다::手にするてにする
손을 대다::手を出すてをだす
눈을 감다::目を閉じるめをとじる
푸른 하늘, 창공::青空あおぞら
청천, 맑은 하늘::晴天せいてん
밝다::明るいあかるい
위험하다, 위태롭다::危ないあぶない
불심자세히 알지 못함, 확실하지 않음의심스러움::不審なふしんな
할 말, 주장, 불평, 이의::言い分いいぶん
목적지::目的地もくてきち
많음, 충분함, 더 필요 없음::たくさん
필요하다::要るいる
필요하다::必要だひつようだ
고르다::選ぶえらぶ
오일::オイル
수다스러운::おしゃべりな
말 잘하는, 말을 많이 하는::よく話すよくはなす
아마, 어쩌면::おそらく
아마::多分たぶん
오프, 스위치가 꺼져 있음::オフ
얼굴을 내밂, 참석함::顔出しかおだし
확인하여::確認してかくにんして
실망하다::がっかりする
실망::失望しつぼう
마음에 들다::気に入るきにいる
좋아하게 되다::好きになるすきになる
싫어지다::嫌いになるきらいになる
흥미를 잃다::興味を失うきょうみをうしなう
주의하다::注意するちゅういする
힘껏::ぐっと
힘을 넣어::力を入れてちからをいれて
살림, 생계, 일상 생활::暮らしくらし
생활하다::生活するせいかつする
계기::契機けいき
결코::決してけっして
건강해지다::元気になるげんきになる
건강을 회복하다::健康を回復するけんこう、かいふく
생각하다::考えるかんがえる
구독하다::購読するこうどくする
공평하게::公平にこうへいに
균등하게::均等にきんとうに
감칠맛::こく
깊은 맛::深みふかみ
코스트, 원가, 가격::コスト
전날, 최근, 요새, 요즈음::この間このあいだ
저번, 전날, 요전, 일전::先日せんじつ
채용하다::採用するさいようする
뽑다, 채집하다, 채용하다::採るとる
문제::問題もんだい
지장이 없다, 방해가 되지 않다::差し支えないさしつかえない
상관없다::構わないかまわない
참가하다::参加するさんかする
샘플::サンプル
신, 장면::シーン
준비, 채비, 몸차림::支度したく
준비::準備じゅうんび
미안하다::すまない
미안하다, 죄송하다, 변명할 여지가 없다::申し訳ないもうしわけない
청결하게 ::清潔にせいけつに
깨끗하게::きれいに
가능한 한::できるだけ
닮다::似ているにている
먹다::食べるたべる
쓰다, 사용하다::使うつかう
잇달아, 차례차례::次々につぎつぎに
꾸짖다, 야단치다, 혼내다::叱るしかる
내용이 있다::内容があるないようがある
연장시키다::延長させるえんちょうさせる
남김없이::残らずのこらず
힌트, 암시, 시사::ヒント
부족하다::不足だふそくだ
페이스::ペース
이곳저곳::あちこち
곧, 머지않아, 이윽고::まもなく間まもなく暖あたたかい春はるが来くるだろう
이제 곧, 머지않아::もうすぐ
훌륭하다, 멋지다, 뛰어나다, 볼 만하다::見事だみごとだ
미스, 실패, 잘못::ミス
가장, 제일, 첫 번째::一番いちばん
청하여 얻다, 받다, 집으로 맞아들이다::もらう
엄하지 않다::厳しくないきびしくない
용의, 준비::用意ようい
케이스, 용기::ケース
주의::注意ちゅうい
예약하다::予約するよやくする
여러 가지, 가지각색의, 갖가지::いろんな
신세를 졌습니다::お世話になりましたせわ
그 외::その他そのほか
무엇이든, 일체, 모두::何もかもなにもかもなにもかも忘わすれて 
뭐라고 하는, 이렇다 할::何と言うなんという
낮은 목소리::低い声ひくいこえ
그저, 아주, 겨우::ほんの~ほんの名なばかりの学者がくしゃ
여러분::皆様みなさま
아날로그::アナログ
앨범::アルバム
앙케트::アンケート
잉크::インク、インキ
인터넷::インターネット
엘리트::エリート
엔진::エンジン
오더, 주문::オーダー
오픈, 개업::オープン
올림픽::オリンピック
카드::カード
카세트::カセット
컷, 삭제::カット
키, 열쇠, 실마리::キー
키워드, 중심어::キーワード
쿨러, 냉방 장치::クーラー
클래스메이트, 급우::クラスメート
그래프::グラフ
크림::クリーム
코너, 구석::コーナー
카피, 복사::コピー
콩쿠르::コンクール
서비스::サービス
웹사이트::サイト
샐러리, 봉급::サラリー
샐러리맨::サラリーマン
시즌::シーズン
쇼::ショー
쇼윈도::ショーウインドー
수프::スープ
스키::スキー
스케이트::スケート
스타트::スタート
스트레스::ストレス
스파게티::スパゲッティ
스피치, 연설::スピーチ
세일, 판매::セール
세미나::ゼミ
세미나::セミナー
터미널::ターミナル
다이어트::ダイエット
타이틀, 제목::タイトル
타이어::タイヤ
댄스, 춤::ダンス
체크아웃::チェックアウト
체크인::チェックイン
체크 포인트::チェックポイント
체인지, 교체, 바꿈::チェンジ
팁::チップ
팀::チーム
테이크아웃::テークアウト, テイクアウト
데이트::デート
디지털::デジタル
디지털카메라::デジタルカメラ
테니스 코트::テニスコート
화장지::トイレットペーパー
드라이브::ドライブ
드라마::ドラマ
퍼센트::パーセント
하드, 엄격함, 고됨::ハード
바이킹::バイキング
패스, 합격::パス
백, 가방::バック
패키지::パッケージ
퍼레이드::パレード
햄버거::ハンバーガー
피크닉, 소풍::ピクニック
비즈니스::ビジネス
비디오::ビデオ
팩스::ファックス
팬::ファン
플러스::プラス
플랫폼::プラットホーム
프랑스::フランス
프린터::プリンター
페트병::ペットボトル
플랫폼, 가정, 홈::ホーム
홈스테이::ホームステイ
홈페이지::ホームページ
볼, 그릇::ボール
포스터::ポスター
호스텔::ホステル
호스트 패밀리::ホストファミリー
마크, 표시::マーク
마라톤::マラソン
맨션::マンション
메일::メール
메세지::メッセージ
메뉴, 식단::メニュー
메모::メモ
메리트, 장점::メリット
사자::ライオン
라이트, 빛::ライト
러시아워::ラッシュアワー
런치::ランチ
리더, 지도자::リーダー
리스트, 목록::リスト
룸, 방::ルーム
룰, 규칙::ルール
렌터카::レンタカー
렌털, 임대::レンタル
원피스::ワンピース
취직::就職しゅうしょく
초조해하다::焦るあせる
다정하다::温かいあたたかい
압승::圧勝あっしょう
압도적::圧倒的あっとうてき
잘못, 틀림, 실수::誤りあやまり
딴 기회에, 다시, 재차, 새삼스레::改めてあらためて
뜻밖에, 의외로::案外あんがい
말하기 어렵다::言い難いいいがたい
용감하다::勇ましいいさましい
이상함::異常いじょう
현저하다, 두드러지다, 명백하다::著しいいちじるしい
이전, 이사, 권리의 양도::移転いてん
기도하다::祈るいのる
위반::違反いはん
의료::医療いりょう
축하하다::祝ういわう
정원수, 분재::植木うえき
떠오르다, 들뜨다::浮くうく
의심::疑いうたがい
운송::運送うんそう
구미, 유럽과 미국::欧米おうべい
춤::踊りおどり
주됨::主おも
아마도::おそらく
일찍이, 예전부터, 여태까지 한 번도, 전혀::かつてかつての栄光えいこうを取とり戻もどす
이전에::以前いぜん
몸집이 작다::小柄だこがらだ
체격이 작다::体が小さいからだがちいさい
속삭이다::ささやく
작은 소리로 이야기하다::小声で話すこごえ
수납하다::収納するしゅうのう
소유하다::所有するしょゆう
가지다::持つもつ
템포, 빠르기, 박자, 속도::テンポ
빠르기, 속도::速さはやさ
묘한::妙なみょうな
과묵하다, 말이 없다::無口だむくちだ
그다지 말하지 않는다::あまり話さない
조금::少しすこし
계산은 마쳤습니다::お勘定は済ませましたかんじょう、す
돈은 지불했습니다::お金は払いました
전부 샀다::全部買ったぜんぶかった
같게 하다::同じにするおな
시끄럽다::うるさい
곧, 바로::すぐに
직전::直前ちょくぜん
애매하다::曖昧だあいまいだ
의외의, 뜻밖의, 예상 밖의, 생각해 본 일도 없는::思いがけないおもい
의외의::意外ないがいな
끝내다, 마치다, 종결짓다::終えるおえる
갖추어지다, 모이다::そろう
모이다::集まるあつまる
필사적이었다::必死だったひっしだった
플랜, 계획::プラン
계획::計画けいかく
스스로::自分でじぶんで
산기슭::山のふもとやま
산의 아래쪽::山の下の方やまのしたのほう
그르친, 잘못된::あやまった
옳지 않은::正しくないただ
꺼칠꺼칠하다, 버석버석하다::かさかさしている
건조하다::乾燥しているかんそう
기묘한::奇妙なきみょうな
완성시키고::完成させてかんせいさせて
꼼짝 않고, 가만히::じっとして
움직이지 않고::動かないでうご
젖어 있다::湿っているしめ
아직 마르지 않았다::まだ乾いていないかわ
상당히, 꽤::かなり
낮, 주간::昼間ひるま
머리를 숙이고::うつむいて
아래를 향하고::下を向いてしたおむいて
회복하다::回復するかいふく
좋아지다::よくなる
녹초가 되었다::くたくただ
몹시 지쳤다::ひどく疲れたひどくつかれた
충분히 주의해서::十分注意してじゅうぶんちゅうい
작아지고, 작아져::小さくなってちいさくなって
유행::流行りゅうこう
대체로::だいたい
우수했다::優秀だったゆうしゅう
머리가 좋았다::頭がよかったあたま
약간, 불과::わずか
인사::あいさつ
가벼운 인사::会釈えしゃく軽かるく会釈えしゃくをする 
과장되다, 대규모다::大げさだおお
견해::見解けんかい
사고방식::考え方かんがえかた
잡담::雑談ざつだん
수다::おしゃべり
몇 번이나::何度もなんども
헐렁헐렁하다::ぶかぶかだ
무척 크다::とても大きいおお
싸게 넘기다::安く譲るやすくゆずる
싸게 팔다::安く売るやすくうる
제멋대로의, 제멋대로 구는::わがままな
머리가 띵해있다, 화가 나 있다::頭にきているあたま
화내고 있다::怒っているおこって
옳지 않다고 말했다::正しくないと言ったただしい、い
사죄하다, 사과하다::おわびするお詫わびの印しるし 
별난, 특이한, 색다른::変わったかわった
공헌할 수 있다::貢献できるこうけん
도움이 되다::役に立つやくにたつ
오락::娯楽ごらく
레저, 여가::レジャー
재삼, 여러 번::再三さいさん
사인, 서명::サイン
서명::署名しょめい
많아봤자::多くてもおおくても
거의 없는::ほとんどない
꼴사납다, 보기 흉하다, 창피하다::みっともない
부끄럽다, 창피하다::恥ずかしいはずかしい
시끄럽다, 떠들썩하다, 성가시다 , 엄하다::やかましい喧やかましい、静しずかにしろ
어쩔 수 없다, 부득이하다::やむをえない
냉정한, 침착한::冷静なれいせいな
침착한, 차분한::落ち着いたおちついた
등불, 불빛::明かりあかり
응석을 받아주다::甘やかすあまやかす
혹은, 또는::あるいは
거칠어지다, 날뛰다::荒れるあれる
어수선하다, 바쁘다::慌ただしいあわただしい
변명, 핑계::言い訳いいわけ
생생한 모양, 활기참::生き生きいきいき
일제히, 동시에::一斉にいっせいに
은퇴::引退いんたい
인용::引用いんよう
묽게 하다, 연하게 하다::薄めるうすめる
밝히다, 털어놓다::打ち明けるうちあける
덮다, 씌우다::覆うおおう
생각이 떠오르다::思いつくおもいつく
온화하고 다정함::温厚おんこう
온난함::温暖おんだん
회견::会見かいけん
해약, 해지::解約かいやく
이루어지다::かなう
감싸다, 비호하다::かばう
기후::気候きこう
가득, 잔뜩, 빽빽이::ぎっしり
급격함::急激きゅうげき
경향::傾向けいこう
아무쪼록::くれぐれも
합동::合同ごうどう
꾸준히 노력하는 모양::こつこつ
재촉::催促さいそく
재배::栽培さいばい
어서, 서둘러, 지체 없이, 빨랑빨랑::さっさと
녹슬다::さびる
지지::支持しじ
실시::実施じっし
배다, 스며들다::しみる
충만, 가득함::充満じゅうまん
취재::取材しゅざい
발생하다, 생기다::生じるしょうじる
초기::初期しょき
초보::初歩しょほ
심각함::深刻しんこく
스피드, 속도::スピード
세간, 세상::世間せけん
세대::世代せだい
속출::続出ぞくしゅつ
대단한, 특별한::大したたいした
다채로움::多彩なたさい
타당::妥当だとう
단정하지 않다, 칠칠하지 못하다::だらしない
중단::中断ちゅうだん
정상, 꼭대기, 절정::頂上ちょうじょう
흩어지다, 널브러지다, 이지러지다::散らかるちらかる
손쉬움, 간단함::手軽てがる
전개::展開てんかい
문의하다::問い合わせるといあわせる
특수::特殊とくしゅ
훨씬 전에, 벌써::とっくに
탁해지다, 흐려지다::濁るにごる
둔하다, 굼뜨다, 반응이 느리다::鈍いにぶい
갈아타다::乗り継ぐのりつぐ
폐지::廃止はいし
발달::発達はったつ
범위::範囲はんい
되돌아가다::引き返すひきかえす
틀어 막다, 가리다::ふさぐ
베테랑, 노련한 사람::ベテラン
보충::補足ほそく
한숨 쉬는 모양, 안심하는 모양::ほっとほっと溜ため息いきをつく
윗사람, 연장자::目上めうえ
어딘가 부족하다::ものたりない
새다, 빠지다, 누설되다::漏れるもれる
간단히 하다, 줄이다, 생략하다::略すりゃくす
논쟁::論争ろんそう
쾌적함::快適かいてき
회복::回復かいふく
확충::拡充かくじゅう
하강, 추락::下降かこう
둘러싸다::囲むかこむ
기울다, 치우치다::傾くかたむく
화물::貨物かもつ
맵다::辛いからい
통조림::缶詰かんづめ
원하고 바람, 소원::願望がんぼう
권유::勧誘かんゆう
완료::完了かんりょう
기억::記憶きおく
기획::企画きかく
위험::危険きけん
기분, 심기::機嫌きげん
겨루다, 경쟁하다::競うきそう
귀중함::貴重きちょう
규모::規模きぼ
구인::求人きゅうじん
공감::共感きょうかん
행사::行事ぎょうじ
어업::漁業ぎょぎょう
극단, 아주 지나침::極端きょくたん
경상::軽傷けいしょう
하순::下旬げじゅん
신발, 구두::靴くつ
경비::警備けいび
엄중함::厳重げんじゅう
교외::郊外こうがい
공해::公害こうがい
고층::高層こうそう
넘다, 초월하다::越えるこえる
고향::故郷こきょう
재판::裁判さいばん
삭제::削除さくじょ
촬영::撮影さつえい
춥다::寒いさむい
찬반, 가부::賛否さんぴ
자극::刺激しげき
축축해지다, 습기 차다::湿るしめる
그 지역, 그 고장, 연고지::地元じもと
수뇌, 정상::首脳しゅのう
상황::状況じょうきょう
정경, 광경::情景じょうけい
초점::焦点しょうてん
생략::省略しょうりゃく
여러 나라::諸国しょこく
자료::資料しりょう
진학률::進学率しんがくりつ
심장::心臓しんぞう
신뢰::信頼しんらい
인류::人類じんるい
수직::垂直すいちょく
구석, 모퉁이::隅すみ
성원::声援せいえん
설비::設備せつび
전쟁::戦争せんそう
총액::総額そうがく
조작::操作そうさ
장치::装置そうち
솔직함::率直そっちょく
갖추다, 대비하다, 마련하다::備えるそなえる
손해::損害そんがい
존중::尊重そんちょう
손익, 손해와 이득::損得そんとく
대신, 장관::大臣だいじん
쓰러뜨리다, 무너뜨리다::倒すたおす
담당자::担当者たんとうしゃ
지혜::知恵ちえ
지각::遅刻ちこく
지식::知識ちしき
추상적::抽象的ちゅうしょうてき
추첨::抽選ちゅうせん
조절::調節ちょうせつ
저자::著者ちょしゃ
저장::貯蔵ちょぞう
치료::治療ちりょう
역할을 맡다, 역할을 다하다::務めるつとめる
센 불::強火つよび
적절함::適切てきせつ
철교::鉄橋てっきょう
전개::展開てんかい
도망::逃亡とうぼう
등산::登山とざん
바로 그 순간, 찰나::途端とたん
도중::途中とちゅう
동반하다, 따르다::伴うともなう
진흙::泥どろ
사이좋게::仲良くなかよく
밉다::憎いにくい
미워하다, 증오하다::憎むにくむ
훔치다::盗むぬすむ
바르다, 칠하다::塗るぬる
열연::熱演ねつえん
배포::配布はいふ
폭발::爆発ばくはつ
부끄러움, 수치::恥はじ
발사::発射はっしゃ
멀어지다, 떨어지다::離れるはなれる
파편::破片はへん
판단::判断はんだん
비극::悲劇ひげき
동등하다, 같다::等しいひとしい
비평::批評ひひょう
피부::皮膚ひふ
표지, 표식::標識ひょうしき
무대::舞台ぶたい
부담::負担ふたん
방재::防災ぼうさい
파다, 캐다::掘るほる
초대하다, 부르다, 초래하다::招くまねく
흐트러지다, 흐려지다::乱れるみだれる
밀폐::密閉みっぺい
인정하다::認めるみとめる
귀찮음, 번거로움::面倒めんどう
구하다, 청하다, 사다::求めるもとめる
모범::模範もはん
고용하다::雇うやとう
풍요로움, 풍부함::豊かゆたか
방심, 부주의::油断ゆだん
요구::要求ようきゅう
용모::容姿ようし
유치함::幼稚ようち
세상::世の中よのなか
냉장고::冷蔵庫れいぞうこ
냉동::冷凍れいとう
연락::連絡れんらく
악천후::悪天候あくてんこう
뻔뻔하다::厚かましいあつかましい
달다, 엄하지 않다::甘いあまい
거칠다, 거세다::荒いあらい
위원회::委員会いいんかい
기세, 힘::勢いいきおい
의뢰::依頼いらい
여쭙다::伺ううかがう
얇다, 연하다, 싱겁다, 적다::薄いうすい
팔::腕うで
원조, 도움::援助えんじょ
추월::追い越しおいこし
놀래키다::驚かせるおどろかせる
개최::開催かいさい
개찰구::改札口かいさつぐち
확대::拡大かくだい
확장::拡張かくちょう
벽::壁かべ
가죽 구두::革靴かわぐつ
감각::感覚かんかく
간결함::簡潔かんけつ
관측::観測かんそく
물가, 절벽, 벼랑::岸きし
귀성::帰省きせい
찻집, 카페::喫茶店きっさてん
우유::牛乳ぎゅうにゅう
경쟁::競争きょうそう
공포::恐怖きょうふ
금액::金額きんがく
구역::区域くいき
계통::系統けいとう
연수::研修けんしゅう
현청::県庁けんちょう
반대를 무릅씀, 억지로 함::強引ごういん
금속화폐, 동전::硬貨こうか
강의::講義こうぎ
호조, 순조, 좋은 상태임::好調こうちょう
광물::鉱物こうぶつ
얼다::凍るこおる
타다, 눋다::焦げるこげる
재적::在籍ざいせき
지갑::財布さいふ
언덕::坂さか
산책::散歩さんぽ
반올림::四捨五入ししゃごにゅう
실천::実践じっせん
습도::湿度しつど
아동::児童じどう
사무소::事務所じむしょ
수확::収穫しゅうかく
주거::住居じゅうきょ
출세::出世しゅっせ
출판사::出版社しゅっぱんしゃ
취미::趣味しゅみ
소개::紹介しょうかい
증기, 수증기::蒸気じょうき
초대::招待しょうたい
상징::象徴しょうちょう
승인::承認しょうにん
소방서::消防署しょうぼうしょ
여배우::女優じょゆう
진지함::真剣しんけん
심야::深夜しんや
물방울::水滴すいてき
구하다, 구제하다::救うすくう
시원하다::涼しいすずしい
정산::精算せいさん
제조::製造せいぞう
제품::製品せいひん
좁다::狭いせまい
탓하다, 책망하다::責めるせめる
총인구::総人口そうじんこう
조직::組織そしき
손, 손해, 불리함::損そん
존경::尊敬そんけい
믿음직스럽다, 기대할 만하다::頼もしいたのもしい
묶다, 통솔하다::束ねるたばねる
단체::団体だんたい
줄이다, 움츠리다::縮めるちぢめる
노력하다, 힘쓰다::努めるつとめる
쌓이다, 어림하다::積もるつもる
저항::抵抗ていこう
전형적::典型的てんけいてき
전통::伝統でんとう
등록::登録とうろく
토론::討論とうろん
배우::俳優はいゆう
잿빛, 회색, 침울함::灰色はいいろ
비판::批判ひはん
줍다::拾うひろう
머금다, 포함하다, 품다::含むふくむ
편집::編集へんしゅう
반품::返品へんぴん
보고서::報告書ほうこくしょ
모자::帽子ぼうし
보석::宝石ほうせき
보증::保証ほしょう
늘다, 많아지다::増すます
축제::祭りまつり
만년필::万年筆まんねんひつ
인도하다::導くみちびく
모두::皆みな
못 보다, 놓치다::見逃すみのがす
맞이, 마중::迎えむかえ
마을::村むら
떼, 무리::群れむれ
명확함::明確めいかく
진귀하다, 드물다::珍しいめずらしい
모임, 행사::催しもよおし
부드러움, 유연함::柔らかやわらか
양기, 명랑함::陽気ようき
욕심::欲よく
기뻐하다, 좋아하다::喜ぶよろこぶ
난폭함::乱暴らんぼう
악영향::悪影響あくえいきょう
미국식::アメリカ流りゅう
알파벳순::アルファベット順じゅん
의학계::医学界いがくかい
하루 걸러::一日おきにいちにちおきに
이문화::異文化いぶんか
이분야, 다른 분야::異分野いぶんや
좀 어둡다, 침침하다::薄暗いうすぐらい
응원단::応援団おうえんだん
부모와 자녀 동반::親子連れおやこづれ
음악 전반::音楽全般おんがくぜんぱん
회원제::会員制かいいんせい
회사원 같은, 회사원풍::会社員風かいしゃいんふう
학년별::学年別がくねんべつ
감기 기운::風邪気味かぜぎみ
가족 동반::家族連れかぞくづれ
임시 채용::仮採用かりさいよう
임시 등록::仮登録かりとうろく
관리하::管理下かんりか
기한이 다 됨::期限切れきげんぎれ
귀 단체::貴団体きだんたい
구 제도::旧制度きゅうせいど
크림 상태::クリーム状クリームじょう
결혼관::結婚観けっこんかん
현실과 동떨어짐::現実離れげんじつばなれ
현 사장::現社長げんしゃちょう
현 제도::現制度げんせいど
현 단계::現段階げんだんかい
높은 수준::高水準こうすいじゅん
국제색::国際色こくさいしょく
아이 동반::子供連れこどもづれ
재개발::再開発さいかいはつ
재방송::再放送さいほうそう
가장 유력함::最有力さいゆうりょく
작품집::作品集さくひんしゅう
사진 포함::写真付きしゃしんづき
취업률, 취직률 ::就職率しゅうしょくりつ
주택가::住宅街じゅうたくがい
집중력::集中力しゅうちゅうりょく
주성분::主成分しゅせいぶん
준결승::準決勝じゅんけっしょう
준우승::準優勝じゅんゆうしょう
초대장::招待状しょうたいじょう
상점가::商店街しょうてんがい
여러 외국::諸外国しょがいこく
식기류::食器類しょっきるい
초년도, 첫 년도::初年度しょねんど
여러 문제::諸問題しょもんだい
성공률::成功率せいこうりつ
정치색::政治色せいじしょく
전 사장::前社長ぜんしゃちょう
전 마을 대표::前町長ぜんちょうちょう
기찻길 옆::線路沿いせんろぞい
매상 총액, 총 판매액::総売上そううりあげ
송신원, 발신지::送信元そうしんもと
부탁하기 곤란하다::頼みづらいたのみづらい
먹기에 적당한 때::食べ頃たべごろ
낮은 가격::低価格ていかかく
저칼로리::低カロリーていカロリー
전철 요금::電車賃でんしゃちん
같은 의견::同意見どういけん
도쿄역발::東京駅発とうきょうえきはつ
투표율::投票率とうひょうりつ
도시에서 자람::都会育ちとかいそだち
여름방학이 끝난 직후::夏休み明けなつやすみあけ
일본식::日本式にほんしき
일본류, 일본식::日本流にほんりゅう
연대순::年代順ねんだいじゅん
일꾼, 일손::働き手はたらきて
반투명::半透明はんとうめい
비공식::非公式ひこうしき
비즈니스맨풍::ビジネスマン風ビジネスマンふう
조금 일을 함::一仕事ひとしごと
부사장::副社長ふくしゃちょう
부대신, 부장관::副大臣ふくだいじん
부정확::不正確ふせいかく
문학상::文学賞ぶんがくしょう
다른 회장::別会場べつかいじょう
공부에 열중임::勉強漬けべんきょうづけ
둥근 형태, 둥근 모양::ボール状ボールじょう
아주 새롭다, 완전히 새것이다::真新しいまあたらしい
바로 뒤::真後ろまうしろ
한밤중, 심야::真夜中まよなか
미경험::未経験みけいけん
미사용::未使用みしよう
분위기 일색::ムード一色ムードいっしょく
무계획::無計画むけいかく
무책임::無責任むせきにん
예약제::予約制よやくせい
유럽풍, 유럽식::ヨーロッパ風ヨーロッパふう
다음 학기::来学期らいがっき
다음 시즌::来シーズンらいシーズン
헤어질 때::別れ際わかれぎわ
공교롭게도::あいにく
애매함::曖昧あいまい
동경::あこがれ
동경하다::あこがれる
발밑::足元あしもと
어필, 호소::アピール
어레인지, 변형, 각색::アレンジ
손쉬움, 안이함::安易あんい
건성임, 무책임함::いいかげん
육아::育児いくじ
유지::保持ほじ
단숨에::一気にいっきに
위도::緯度いど
말하자면, 예를 들면, 이른바::いわば
소위, 이른바::いわゆる
꾸벅꾸벅 조는 모양::うとうと
과감히, 큰맘 먹고::思い切っておもいきって
해산::解散かいさん
개설::開設かいせつ
개조::改造かいぞう
빠뜨리다, 빼먹다, 거르다::欠かすかかす
빛나다, 반짝이다, 훌륭하다, 눈부시다::輝かしいかがやかしい
각오::覚悟かくご
굳히다::固めるかためる
활기::活気かっき
활발함::活発かっぱつ
칼로리, 열량::カロリー
선뜻, 가벼운 마음으로::気軽にきがるに
효과가 있다::効くきく
아슬아슬함, 빠듯함::ぎりぎり
푸념을 하다::ぐちを言うぐちをいう
녹초가 됨, 늘어짐::ぐったり
장황하다, 되풀이해서 귀찮다::くどい
후회하다, 애석하게 여기다::悔やむくやむ
클리어, 통과하다, 헤쳐나가다::クリア
극적으로::劇的にげきてきに
사양 않고::ご遠慮なくごえんりょなく
어지러이 뒤섞임, 너저분한 모양::ごちゃごちゃ
거스르다, 거역하다::逆らうさからう
그건 그렇고, 자, 이제::さて
시간을 때우다::時間をつぶすじかんをつぶす
바로, 곧, 금방::直にじきに
깔다, 설치하다::敷くしく
수수함, 검소함::地味じみ
방해, 거추장스러움::邪魔じゃま
상승::上昇じょうしょう
서서히::徐々にじょじょに
쇼크, 충격::ショック
빤히, 유심히::じろじろ
진출::進出しんしゅつ
틈, 방심::隙すき
말쑥함, 상쾌함::すっかり
스무스, 순조로움, 원활함::スムーズ
사치스러움::ぜいたく
전념::専念せんねん
상이함, 다름::相違そうい
그러고 보니::そういえば
경솔하다, 덜렁대다::そそっかしい
체격::体格たいかく
타이밍::タイミング
다만::ただし
듬뿍, 많이::たっぷり
착착, 척척::着々とちゃくちゃくと
중계::中継ちゅうけい
흩뿌리다, 어지르다::散らかすちらかす
통하지 않다::通じないつうじない
발에 걸려 넘어지다, 실패하다::つまずく
꽉 차다, 잔뜩 쌓이다, 막히다::詰まるつまる
제공::提供ていきょう
정정::訂正ていせい
적당한 정도, 적당함, 적절함::適度てきど
적당함, 합리적인::手ごろてごろ
엉터리로, 아무렇게나::でたらめに
전근::転勤てんきん
점검::点検てんけん
도입::導入どうにゅう
특색::特色とくしょく
독특::独特どくとく
흩날리다::飛び散るとびちる
당치 않다::とんでもない
그립다, 반갑다::懐かしいなつかしい
니즈, 요구::ニーズ
빙긋이::にっこり
박수::拍手はくしゅ
발휘::発揮はっき
화려함::派手はで
이야기가 끊기지 않다::話が尽きないはなしがつきない
밸런스, 균형::バランス
반영::反映はんえい
펑크, 터짐::パンク
말리다, 붙잡다::引き止めるひきとめる
소곤소곤::ひそひそ
흠뻑 젖음::びっしょり
비례::比例ひれい
민감함::敏感びんかん
불안정::不安定ふあんてい
프레셔, 압력::プレッシャー
분석::分析ぶんせき
분담::分担ぶんたん
진짜, 실물::本物ほんもの
멍하니, 흐릿하게::ぼんやり
자기 페이스, 자기 나름의 방식::マイペース
듣다::耳にするみみにする
푹 빠지다, 열중하다::夢中になるむちゅうになる
명소::名所めいしょ
목표로 하다::目指すめざす
면하다, 마주보다::面するめんする
유리함::有利ゆうり
유쾌함::愉快ゆかい
용적::容積ようせき
예측::予測よそく
불러 세우다::呼び止めるよびとめる
릴랙스, 편안함::リラックス
비교적::わりと
사랑::愛あい
애음, 즐겨 마심::愛飲あいいん
애정::愛情あいじょう
애인, 정부, 불륜 상대::愛人あいじん
적자::赤字あかじ
악수::握手あくしゅ
악마::悪魔あくま
새벽녘, 동틀녘::明け方あけがた
발자취, 발자국::足跡あしあと
적, 원수, 원한::あだ
압축::圧縮あっしゅく
모임, 화합::集まりあつまり
압력::圧力あつりょく
받는 사람, 수신인::宛名あてな
자국, 흔적, 유적::跡あと
앞뒤, 전후::後先あとさき
뒤치다꺼리, 뒤처리::後始末あとしまつ
덧문::雨戸あまど
나머지, 여분::余りあまり
편물, 뜨개질::編み物あみもの
대충의 줄거리, 개요::あらすじ
나타남, 나타난 것, 현상, 발로::現れあらわれ
개미::あり
현실, 본연의 자세::在り方ありかた
간, 맛, 상태::あんばい
안부, 안위::安否あんぴ
위원::委員いいん
살아 있는 것, 생물::生き物いきもの
꽃꽃이::生け花いけばな
이행::移行いこう
유산::遺産いさん
의사, 의향::意思いし
이주::移住いじゅう
의식주::衣食住いしょくじゅう
판자, 널빤지::板いた
못된 장난::いたずら
일조, 약간의 도움::一助いちじょ
시장, 장::市場いちば
일람::一覧いちらん
일가::一家いっか
일괄::一括いっかつ
그저께::一昨日いっさくじつ
재작년::一昨年いっさくねん
일순, 한순간::一瞬いっしゅん
일치::一致いっち
일정, 변화가 없는 것, 정해져 있는 것::一定いってい
유전::遺伝いでん
우물::井戸いど
이동, 인사이동::異動いどう
사촌::いとこ
틈, 겨를, 휴식::いとま
벼::稲いね
의복, 옷::衣服いふく
의역::意訳いやく
갈아 넣음, 교체::入れ替えいれかえ
음료수::飲料水いんりょうすい
물고기::魚うお
양치질::うがい
토끼::うさぎ
알맞음, 안성맞춤::打って付けうってつけ
그릇, 용기::器うつわ
우천, 비오는 날::雨天うてん
통째로 삼킴, 그대로 받아들임::うのみ
탄생, 출생::生まれうまれ
유무::有無うむ
매실::梅うめ
뒷문::裏口うらぐち
원한, 앙심::恨みうらみ
근심, 걱정::憂いうれい
팔림새::売れ行きうれゆき
운, 운명::運うん
운하::運河うんが
운세::運勢うんせい
영광::栄光えいこう
영자, 영문자::英字えいじ
영사::映写えいしゃ
위생::衛生えいせい
영상::映像えいぞう
영문::英文えいぶん
영양분::栄養分えいようぶん
영일, 영어와 일본어::英和えいわ
액, 즙, 액체::液えき
먹이::えさ
지엽, 사소한 일::枝葉えだは
연회, 잔치::宴会えんかい
원예::園芸えんげい
연극::演劇えんげき
원주, 원둘레::円周えんしゅう
연습, 반복하여 익힘, 실전을 상정하여 실시하는 훈련::演習えんしゅう
연출::演出えんしゅつ
굴뚝::煙突えんとつ
사양, 삼감::遠慮えんりょ
왕::王おう
임금님::王様おうさま
왕자::王子おうじ
공주::王女おうじょ
왕생, 체념, 단념, 난감함, 죽음::往生おうじょう
응접, 접대::応接おうせつ
응답::応答おうとう
집주인::大家おおや
먼 바다::沖おき
사모님, 안주인::奥様おくさま
늦음::遅れおくれ
오염::汚染おせん
남편::夫おっと
가사도우미::お手伝いさんおてつだいさん
분실물::落とし物おとしもの
놀람::驚きおどろき
귀신::鬼おに
띠::帯おび
기억, 경험, 이해::覚えおぼえ
신불을 참배하러 감, 참배::お参りおまいり
문득 생각이 남, 착상::思いつきおもいつき
추억::追憶ついおく
엄지손가락, 엄지발가락::親指おやゆび
직물::織物おりもの
은혜::恩おん
은혜, 혜택::恩恵おんけい
온실::温室おんしつ
온대::温帯おんたい
온난화::温暖化おんだんか
귀중, 귀하::御中おんちゅう
온도::温度おんど
모기::蚊か
조개, 조가비::貝かい
해, 손해::害がい
회원::会員かいいん
개연, 공연을 시작함::開演かいえん
개화::開花かいか
개회::開会かいかい
해외::海外かいがい
회관::会館かいかん
회계::会計かいけい
개강::開講かいこう
회합::会合かいごう
외교::外交がいこう
개시::開始かいし
해석::解釈かいしゃく
해수욕::海水浴かいすいよく
횟수::回数かいすう
쾌청::快晴かいせい
회송::回送かいそう
개통::開通かいつう
회전::回転かいてん
외신, 외전::外電がいでん
가도, 간선도로::街道かいどう
가두, 길거리::街頭がいとう
가등, 가로등::街灯がいとう
외투::外套がいとう
해당::該当がいとう
외부::外部がいぶ
개봉::開封かいふう
개방::開放かいほう
해방::解放かいほう
해양::海洋かいよう
개량::改良かいりょう
개론::概論がいろん
가옥::家屋かおく
화가::画家がか
화학::化学かがく
등기, 써서 남겨 둠::書留かきとめ
베껴 씀, 받아쓰기::書き取りかきとり
문서, 글을 씀::書き物かきもの
각위, 여러분::各位かくい
학위::学位がくい
격언::格言かくげん
학사::学士がくし
학자::学者がくしゃ
학술::学術がくじゅつ
각인, 각자::各人かくじん
각각의 가설::各説かくせつ
학년::学年がくねん
학문::学問がくもん
확률::確率かくりつ
그늘::陰かげ
그림자::影かげ
곱셈::掛け算かけざん
바구니::かご
화구, 화산의 분화구::火口かこう
화합::化合かごう
꾸밈, 장식::飾りかざり
가사, 집안일::家事かじ
과실, 열매::果実かじつ
셋방::貸間かしま
가수::歌手かしゅ
과세::課税かぜい
가속::加速かそく
가속도::加速度かそくど
본, 거푸집, 틀, 형식::型かた
칼, 검::刀かたな
가치::価値かち
학과::学科がっか
학회::学会がっかい
학기::学期がっき
학급::学級がっきゅう
괄호::括弧かっこ
활자::活字かつじ
활용::活用かつよう
활력::活力かつりょく
과정, 프로세스::過程かてい
가열::加熱かねつ
과반수::過半数かはんすう
곰팡이::かび
그루, 포기, 주식::株かぶ
솥, 가마::かま
휴지, 종이 부스러기::紙くずかみくず
면도칼::かみそり
천둥, 우레, 벼락::雷かみなり
머리털, 머리카락::髪の毛かみのけ
가요::歌謡かよう
껍질, 껍데기::殻から
몸집, 품위, 무늬::柄がら
텅 빔::空っぽからっぽ
놀이딱지, 놀이카드::かるた
외환::為替かわせ
기와::かわら
캔, 통조림::缶かん
직감, 육감::勘かん
간이::簡易かんい
환기::換気かんき
감격::感激かんげき
관서::関西かんさい
환자::患者かんじゃ
감상, 예술 작품을 즐기고 이해하는 것::鑑賞かんしょう
간접::間接かんせつ
한대::寒帯かんたい
착각::勘違いかんちがい
건전지::乾電池かんでんち
관동::関東かんとう
건배::乾杯かんぱい
간판::看板かんばん
간병::看病かんびょう
관련::関連かんれん
기압::気圧きあつ
의회::議会ぎかい
기관::機関きかん
기관차::機関車きかんしゃ
기관총::機関銃きかんじゅう
듣고 이해함::聞き取りききとり
기근::飢饉ききん
기구::器具きぐ
옷감, 천::生地きじ
기사, 기술자::技師ぎし
기자::記者きしゃ
규준, 규범, 기준::規準きじゅん
기상::起床きしょう
기질, 성질::気性きしょう
기수, 홀수::奇数きすう
기지::基地きち
의장::議長ぎちょう
차를 마심::喫茶きっさ
여우::きつね
기백::気迫きはく
기본::基本きほん
기명::記名きめい
객석::客席きゃくせき
응접실, 객실::客間きゃくま
급, 등급, 단계::級きゅう
휴가::休暇きゅうか
휴학::休学きゅうがく
휴게, 휴식::休憩きゅうけい
휴강::休講きゅうこう
흡수::吸収きゅうしゅう
급소, 핵심::急所きゅうしょ
구조, 위험한 상태에서 구하여 주는 것::救助きゅうじょ
급여, 급료::給与きゅうよ
교원, 교사::教員きょういん
강화::強化きょうか
교과서::教科書きょうかしょ
경기::競技きょうぎ
예의범절, 행동거지::行儀ぎょうぎ
공급::供給きょうきゅう
교재::教材きょうざい
교수::教授きょうじゅ
황송함, 죄송함::恐縮きょうしゅく
강조::強調きょうちょう
강풍::強風きょうふう
교양::教養きょうよう
행렬::行列ぎょうれつ
안개::霧きり
규율, 질서::規律きりつ
기력, 기백::気力きりょく
조각, 직물, 옷감, 자투리 천::切れきれ
금붕어::金魚きんぎょ
금고::金庫きんこ
근시::近眼きんがん
금전::金銭きんせん
금속::金属きんぞく
근대::近代きんだい
근육::筋肉きんにく
근무::勤務きんむ
금융::金融きんゆう
글귀, 구절::句く
말뚝::くい
공간::空間くうかん
우수, 짝수::偶数ぐうすう
공상::空想くうそう
공중::空中くうちゅう
구획::区画くかく
구간::区間くかん
못::くぎ
단락::区切りくぎり
쇠사슬::鎖くさり
빗::くし
재채기::くしゃみ
고심::苦心くしん
쓰레기, 찌꺼기::くず
약지::薬指くすりゆび
관, 대롱::管くだ
입술::唇くちびる
입술 연지, 립스틱::口紅くちべに
고통::苦痛くつう
구두점, 마침표와 쉼표::句読点くとうてん
구분::区分くぶん
짜맞춤, 조합, 편성::組み合わせくみあわせ
저묾, 저물 때::暮れくれ
흑자::黒字くろじ
훈, 가르침::訓くん
군, 군대::軍ぐん
군, 무리, 떼::群ぐん
군대::軍隊ぐんたい
계, 합계::計けい
경의::敬意けいい
경어::敬語けいご
형광등::蛍光灯けいこうとう
경고::警告けいこく
게재::掲載けいさい
경제::経済けいざい
경찰::警察けいさつ
형사::刑事けいじ
털실::毛糸けいと
경마::競馬けいば
경품::景品けいひん
형용사::形容詞けいようし
모피::毛皮けがわ
극장::劇場げきじょう
격증, 급증::激増げきぞう
하차::下車げしゃ
화장::化粧けしょう
하수::下水げすい
나막신::げた
월급::月給げっきゅう
걸작::傑作けっさく
결단::決断けつだん
혈통::血統けっとう
월말::月末げつまつ
해열::解熱げねつ
검열::検閲けんえつ
원고::原稿げんこう
검색::検索けんさく
원산::原産げんさん
현실::現実げんじつ
현상, 현 상황::現状げんじょう
검진::検診けんしん
겸손::謙遜けんそん
건축가::建築家けんちくか
한도::限度げんど
현장::現場げんば
현미경::顕微鏡けんびきょう
헌법::憲法けんぽう
권리::権利けんり
원리::原理げんり
감량::減量げんりょう
가루, 분말::粉こ
말, 언어, 말씨::語ご
바둑::碁ご
사랑, 연애::恋こい
고안::考案こうあん
공장 직원, 공장 노동자::工員こういん
공연::公演こうえん
호화::豪華こうか
공개::公開こうかい
공학::工学こうがく
항공::航空こうくう
광경::光景こうけい
공예::工芸こうげい
공격::攻撃こうげき
효행, 효도::孝行こうこう
교차::交差こうさ
광산::鉱山こうざん
구실::口実こうじつ
교사, 학교 건물::校舎こうしゃ
후자::後者こうしゃ
향수::香水こうすい
구성::構成こうせい
공적::功績こうせき
광선::光線こうせん
고속::高速こうそく
공단::公団こうだん
경지, 경작지::耕地こうち
교통기관::交通機関こうつうきかん
긍정::肯定こうてい
고도::高度こうど
광열비::光熱費こうねつひ
효능::効能こうのう
후반::後半こうはん
공표::公表こうひょう
교부::交付こうふ
후보::候補こうほ
항목::項目こうもく
공용::公用こうよう
단풍::紅葉こうよう、もみじ
효용::効用こうよう
합리::合理ごうり
공립::公立こうりつ
합류::合流ごうりゅう
효력::効力こうりょく
고령::高齢こうれい
오해::誤解ごかい
어학::語学ごがく
국왕::国王こくおう
국적::国籍こくせき
국토::国土こくど
고발::告発こくはつ
곡물::穀物こくもつ
국립::国立こくりつ
잔소리::小言こごと
짐작, 짐작 가는 곳::心当たりこころあたり
거지, 비렁뱅이::こじき
후추::こしょう
개성::個性こせい
국경::国境こっきょう
고전::苦戦くせん
거문고::琴こと
어두::語頭ごとう
말씨, 말투::言葉遣いことばづかい
속담::ことわざ
가루, 분말, 특히 밀가루::粉こな
어미::語尾ごび
격조함, 무소식::ごぶさた
작은 집, 오두막집::小屋こや
새끼손가락, 새끼발가락::小指こゆび
감색, 남색::紺こん
끈기::根気こんき
앞으로, 이후::今後こんご
혼합::混合こんごう
근성::根性こんじょう
금일, 오늘날::今日こんにち
재학::在学ざいがく
재산::財産ざいさん
국경일, 제삿날::祭日さいじつ
재생::再生さいせい
최선::最善さいぜん
채점::採点さいてん
재난::災難さいなん
재봉, 바느질::裁縫さいほう
재목, 목재::材木ざいもく
경계, 갈림길::境さかい
그끄저께::さきおととい
먼 장래, 도처::先先さきざき
색인::索引さくいん
작자::作者さくしゃ
작물, 농작물::作物さくもつ
숟가락::さじ
다다미방, 객실::座敷ざしき
생선회::刺身さしみ
잡음::雑音ざつおん
작가::作家さっか
돈다발, 돈뭉치::札束さつたば
사막::砂漠さばく
녹::さび
방석::座布団ざぶとん
원숭이::猿さる
소동, 소란::騒ぎさわぎ
참관::参観さんかん
찬성::賛成さんせい
산소::酸素さんそ
산림::山林さんりん
시::詩し
완성, 됨됨이::仕上がりしあがり
글피::しあさって
자위, 스스로 방위함::自衛じえい
시계, 시야::視界しかい
사각, 사각형, 네모꼴::四角しかく
사계, 사계절, 사철::四季しき
부지, 대지::敷地しきち
사업::事業じぎょう
사항::事項じこう
시찰::視察しさつ
자살::自殺じさつ
지참::持参じさん
사실::事実じじつ
자석::磁石じしゃく
시종일관, 자초지종::始終しじゅう
자습::自習じしゅう
지출::支出ししゅつ
시장::市場しじょう
시인::詩人しじん
자연과학::自然科学しぜんかがく
시속::時速じそく
지속::持続じぞく
자손::子孫しそん
사체, 시체::死体したい
순서, 절차, 수속, 되어 가는 대로::次第しだい
자체, 서체::字体じたい
초고, 초안::下書きしたがき
자택::自宅じたく
번화가::下町したまち
자치::自治じち
방::室しつ
질::質しつ
실감::実感じっかん
습기::湿気しっけ
실습::実習じっしゅう
실지, 현장, 실제의 장소::実地じっち
실물::実物じつぶつ
꼬리::しっぽ
실무::実務じつむ
실례, 실제 사례::実例じつれい
실연::失恋しつれん
사철, 민간 철도::私鉄してつ
시발, 처음 떠남, 처음 생김::始発しはつ
잔디밭::芝生しばふ
지반::地盤じばん
지폐, 종이돈::紙幣しへい
자본::資本しほん
줄무늬::しま
끝, 마지막::しまい
자매::姉妹しまい
사무::事務じむ
사명::使命しめい
지면::地面じめん
서리::霜しも
아래, 밑 하류::下しも
사회과학::社会科学しゃかいかがく
수도꼭지::蛇口じゃぐち
차고::車庫しゃこ
차장::車掌しゃしょう
사생::写生しゃせい
빚::借金しゃっきん
딸꾹질::しゃっくり
차륜, 수레 바퀴::車輪しゃりん
가위바위보::じゃんけん
총::銃じゅう
집회::集会しゅうかい
종교::宗教しゅうきょう
수금::集金しゅうきん
집계::集計しゅうけい
습자, 글자 쓰기를 익힘::習字しゅうじ
수정::修正しゅうせい
수선, 수리::修繕しゅうぜん
충족::充足じゅうそく
중태::重体じゅうたい
융단, 양탄자::じゅうたん
종점::終点しゅうてん
중점::重点じゅうてん
취임::就任しゅうにん
주변::周辺しゅうへん
수료::修了しゅうりょう
중력::重力じょうりょく
주연::主演しゅえん
숙어::熟語じゅくご
국경일::祝日しゅくじつ
주어::主語しゅご
주인공::主人公しゅじんこう
주체::主体しゅたい
주제::主題しゅだい
출연::出演しゅつえん
출혈::出血しゅっけつ
출현::出現しゅつげん
술어, 서술어::述語じゅつご
출산::出産しゅっさん
출사, 출근::出社しゅっしゃ
출장, 출전::出場しゅつじょう
출생::出生しゅっしょう
출제::出題しゅつだい
출동::出動しゅつどう
출비, 지출::出費しゅっぴ
출품::出品しゅっぴん
주임::主任しゅにん
주부::主婦しゅふ
주력::主力しゅりょく
수화기::受話器じゅわき
순간::瞬間しゅんかん
순환::循環じゅんかん
순경::巡査じゅんさ
순서::順序じゅんじょ
순정::純情じゅんじょう
방법, 도리::仕様しよう
상위::上位じょうい
상영::上映じょうえい
상연::上演じょうえん
장해, 장애::障害しょうがい
자, 기준, 본보기, 모범, 사물의 표준::定規じょうぎ
상경::上京じょうきょう
상금::賞金しょうきん
상공, 하늘::上空じょうくう
상하::上下じょうげ
충격::衝撃しょうげき
정오::正午しょうご
상세, 자세한 내용::詳細しょうさい
상식::常識じょうしき
상사, 상사 회사::商社しょうしゃ
상순::上旬じょうじゅん
정세::情勢じょうせい
기능이 향상됨, 숙달::上達じょうたつ
소독::消毒しょうどく
피고용인, 이용자::使用人しようにん
상인::商人しょうにん
승패::勝敗しょうはい
장사::商売しょうばい
증발::蒸発じょうはつ
소비자::消費者しょうひしゃ
승부, 승패::勝負しょうぶ
소변::小便しょうべん
소방::消防しょうぼう
알맹이, 정량, 실제::正味しょうみ
소모::消耗しょうもう
승리::勝利しょうり
초급::初級しょきゅう
조교수::助教授じょきょうじゅ
직, 직책::職しょく
식염::食塩しょくえん
식탁::食卓しょくたく
직공, 장인::職人しょくにん
식물::植物しょくぶつ
먹을 것, 식품, 음식물::食物しょくもつ
식품, 식대, 식비::食料しょくりょう
식량::食糧しょくりょう
서재::書斎しょさい
초순, 상순::初旬しょじゅん
서적::書籍しょせき
소속::所属しょぞく
서도, 서예::書道しょどう
소득::所得しょとく
서책, 책, 도서::書物しょもつ
백발::白髪しらが
알림, 통지::知らせしらせ
엉덩이::尻しり
자립::自立じりつ
즙, 물::汁しる
성::城しろ
초심자, 풋내기::素人しろうと
주름, 구김살::しわ
심, 심지::芯しん
인격::人格じんかく
심경, 마음::心境しんきょう
진공::真空しんくう
신앙::信仰しんこう
진행::進行しんこう
인공::人工じんこう
신고::申告しんこく
진찰::診察しんさつ
인사, 인간사::人事じんじ
신자::信者しんじゃ
심신::心身しんしん
새로운 학설::新説しんせつ
인조::人造じんぞう
침대::寝台しんだい
진동::振動しんどう
진입::進入しんにゅう
침입::侵入しんにゅう
심판::審判しんぱん
인물::人物じんぶつ
인문과학::人文科学じんぶんかがく
친우, 친한 벗::親友しんゆう
심리::心理しんり
삼림, 숲::森林しんりん
친척, 일가::親類しんるい
인류학::人類学じんるいがく
침로, 나아갈 길::針路しんろ北きたに針路しんろを取とる 
신화::神話しんわ
초, 식초::酢す
수산::水産すいさん
취사::炊事すいじ
수준::水準すいじゅん
수증기::水蒸気すいじょうき
수소::水素すいそ
추정::推定すいてい
수통::水筒すいとう
수필::随筆ずいひつ
수분::水分すいぶん
수평::水平すいへい
수평선::水平線すいへいせん
수면, 잠::睡眠すいみん
끝, 마지막, 말단::末すえ
막내::末っ子すえっこ
도감::図鑑ずかん
삼나무::杉すぎ
호불호, 좋고 싫음::好き嫌いすききらい
각자의 기호::好き好きすきずき
도형::図形ずけい
줄기, 줄거리, 힘줄::筋すじ
방울::鈴すず
두뇌::頭脳ずのう
도표, 그래프::図表ずひょう
길이, 치수::寸法すんぽう
생, 삶::生せい
성, 성씨::姓せい
성질, 성격, 성::性せい
올바름, 정도::正せい
세, 세금::税ぜい
세관::税関ぜいかん
세기::世紀せいき
청구, 요구::請求せいきゅう
생계::生計せいけい
정식::正式せいしき
성질::性質せいしつ
청춘::青春せいしゅん
청소년::青少年せいしょうねん
정신::精神せいしん
성인, 어른::成人せいじん
정수::整数せいすう
청소::清掃せいそう
생장, 성장::生長せいちょう
정비::整備せいび
정방형, 정사각형::正方形せいほうけい
성명, 이름::姓名せいめい
성명, 의견::声明せいめい
제약, 제한::制約せいやく
생리::生理せいり
성립::成立せいりつ
세력::勢力せいりょく
서력, 서기::西暦せいれき
기침::咳せき
석탄::石炭せきたん
적도::赤道せきどう
석유::石油せきゆ
세대, 가구::世帯せたい
설, 주장, 의견::説せつ
접근::接近せっきん
설계::設計せっけい
절호, 더 없이 좋음::絶好ぜっこう
접촉::接触せっしょく
설정::設定せってい
설득::説得せっとく
절멸, 멸종, 근절::絶滅ぜつめつ
도자기::瀬戸物せともの
대사, 틀에 박힌 말::せりふ
마개, 수도 따위의 개폐 장치::栓せんビール瓶びんの栓せん 消火しょうか栓せん 
선, 올바르고 착함::善ぜん
전액::全額ぜんがく
선거::選挙せんきょ
전업::専業せんぎょう
전언, 앞서 한 말::前言ぜんげん
세제::洗剤せんざい
선출::選出せんしゅつ
전진::前進ぜんしん
쥘부채::扇子せんす
지지난달, 전전달::先々月せんせんげつ
전전주::先々週せんせんしゅう
선조::先祖せんぞ
전속::専属せんぞく
첨단, 선두::先端せんたん
선착::先着せんちゃく
선두::先頭せんとう
선풍기::扇風機せんぷうき
세면::洗面せんめん
전용::専用せんよう
선로::線路せんろ
코끼리::象ぞう
소음::騒音そうおん
송금::送金そうきん
걸레::ぞうきん
창고::倉庫そうこ
창작::創作そうさく
소제, 청소::掃除そうじ
장례식::葬式そうしき
조선::造船ぞうせん
상속::相続そうぞく
증대::増大ぞうだい
송별::送別そうべつ
총리대신::総理大臣そうりだいじん
송료, 배송료, 운송료::送料そうりょう
측정::測定そくてい
측량::測量そくりょう
소질::素質そしつ
선조, 조상::祖先そせん
속행::続行ぞっこう
주판, 계산, 이해타산::そろばん
손실::損失そんしつ
논::田た
퇴학::退学たいがく
대학원::大学院だいがくいん
대기, 공기::大気たいき
목수::大工だいく
체계::体系たいけい
대결::対決たいけつ
체험::体験たいけん
북::太鼓たいこ
대책::対策たいさく
체중::体重たいじゅう
퇴출::退出たいしゅつ
대상::対象たいしょう
대조::対照たいしょう
대소, 크고 작음::大小だいしょう
퇴장::退場たいじょう
대두, 콩::大豆だいず
체제::体制たいせい
체적, 부피::体積たいせき
대전::対戦たいせん
체조::体操たいそう
태도::態度たいど
대통령::大統領だいとうりょう
대비, 대조::対比たいひ
대부분, 거의::大部分だいぶぶん
체포::逮捕たいほ
대목, 거목, 큰 나무::大木たいぼく
대명사::代名詞だいめいし
대리::代理だいり
대화::対話たいわ
모내기, 이앙::田植えたうえ
타원::楕円だえん
보물, 보배::宝たから
폭포::滝たき
도움,구조::助けたすけ
싸움, 전쟁::戦いたたかい
설 곳, 입장, 처지, 관점::立場たちば
탈선::脱線だっせん
탈퇴::脱退だったい
일본식 버선::足袋たび
구, 공::球たま、きゅう

옥, 구슬::玉たま
총알, 탄알::弾たま
시험, 시도::試しためし
편지, 소식, 정보::便りたより
의지, 연고, 연줄::頼りたより
단, 계단::段だん
단계::段階だんかい
단기::短期たんき
탄광::炭鉱たんこう
탄생::誕生たんじょう
옷장, 장롱::たんす
담수, 민물::淡水たんすい
전문대학::短大たんだい
단독::単独たんどく
단편::短編たんぺん
치안::治安ちあん
지역::地域ちいき
지하수::地下水ちかすい
지질::地質ちしつ
지인::知人ちじん
지성::知性ちせい
지대::地帯ちたい
지점, 곳::地点ちてん
지능::知能ちのう
지평선::地平線ちへいせん
착륙::着陸ちゃくりく
중앙::中央ちゅうおう
중세::中世ちゅうせい
중도::中途ちゅうと
장녀, 맏딸::長女ちょうじょ
조정::調整ちょうせい
받음::ちょうだい
장단, 길고 짧음, 장단점::長短ちょうたん
정점, 정상, 꼭데기::頂点ちょうてん
장남, 맏아들::長男ちょうなん
장방형, 직사각형::長方形ちょうほうけい
조미료::調味料ちょうみりょう
조리::調理ちょうり
직후, 바로 뒤::直後ちょくご
직선::直線ちょくせん
직통::直通ちょくつう
직역::直訳ちょくやく
직류::直流ちょくりゅう
직각::直角ちょっかく
직경::直径ちょっけい
통과::通過つうか
통화, 유통 화폐::通貨つうか
통장::通帳つうちょう
통역::通訳つうやく
통용::通用つうよう
통로::通路つうろ
막다른 곳::突き当たりつきあたり
세월, 시간, 월일, 날짜::月日つきひ
만듦, 만듦새, 몸집::作りつくり
밧줄::綱つな
날개, 새날개, 비행기의 날개::翼つばさ
알, 낱알::粒つぶ粒が小さい粟
죄::罪つみ
손톱, 발톱::つめ
윤기, 광택::つや
장마::梅雨つゆ・ばいう
강한 편임::強目つよめ
낚시::釣りつり
동행, 한패::連れつれ
우연히 만남::出会い・出合いであい
저하::低下ていか
정가::定価ていか
정기권::定期券ていきけん
정기 휴일::定休日ていきゅうび
정차::停車ていしゃ
제출::提携ていけい
정착::定着ていちゃく
정년::定年ていねん
출입, 드나듦::出入りでいり
출입구::出入り口でいりぐち
정류소, 정류장::停留所ていりゅうじょ
고침, 손질함, 보살핌::手入れていれ
적::敵てき
적용::適用てきよう
손목::手首てくび
제자::弟子でし
요술, 속임수::手品てじな
수첩::手帳てちょう
철, 쇠::鉄てつ
철학::哲学てつがく
철저::徹底てってい
철도::鉄道てつどう
총, 총포류::鉄砲てっぽう
수건::手ぬぐいてぬぐい
전구::電球でんきゅう
천후, 기후, 날씨::天候てんこう
천재::天才てんさい
천재, 자연재해::天災てんさい
점자::点字てんじ
천장::天井てんじょう
전직, 이직::転職てんしょく
점수::点数てんすう
전염::伝染でんせん
전신주, 전봇대::電柱でんちゅう
전류::電流でんりゅう
당, 무리::党とう
탑::塔とう
동, 구리::銅どう
통일::統一とういつ
동격::同格どうかく
고개, 고비::峠とうげ
통계::統計とうけい
등교::登校とうこう
동행::同行どうこう
동작::動作どうさ
동서::東西とうざい
당시::当時とうじ
동사::動詞どうし
동시::同時どうじ
당일::当日とうじつ
투서::投書とうしょ
당선::当選とうせん
도주::逃走とうそう
등대::灯台とうだい
도덕::道徳どうとく
도난::盗難とうなん
당번::当番とうばん
도피::逃避とうひ
투표::投票とうひょう
등분::等分とうぶん
등유::灯油とうゆ
동양::東洋とうよう
동료::同僚どうりょう
동력::動力どうりょく
도회, 도시::都会とかい
독::毒どく
독점, 독차지::独占どくせん
특매, 특별히 싸게 팜::特売とくばい
도서::図書としょ
도심::都心としん
찬장::戸棚とだな
호랑이, 범::虎とら
덮밥::丼どんぶり
내선::内線ないせん
전망, 풍경::眺めながめ
중지, 가운뎃손가락::中指なかゆび
사이가 좋음::仲良しなかよし
없음::無しなし
수수께끼, 불가사의::なぞ
냄비::鍋なべ
괴로움, 고민::悩みなやみ
새끼, 포승줄::縄なわ
난관::難関なんかん
남극::南極なんきょく
남미::南米なんべい
남북::南北なんぼく
무지개::虹にじ
일상::日常にちじょう
일상용품, 생필품::日用品にちようひん
일광, 햇볕::日光にっこう
입수::入手にゅうしゅ
입상::入賞にゅうしょう
처, 아내::女房にょうぼう
임무::任務にんむ
값이 오름::値上がりねあがり
값이 내림::値下がりねさがり
쥐::ねずみ
열대::熱帯ねったい
열중::熱中ねっちゅう
값을 깎음, 깎아 줌::値引ねびき
잠옷::寝巻ねまき
뿌리, 근본::根本ねもと
겨냥, 목적::狙いねらい
연간::年間ねんかん
연공서열::年功序列ねんこうじょれつ
연시, 연초::年始ねんし
연말::年末ねんまつ
뇌::脳のう
농가::農家のうか
농산물::農産物のうさんぶつ
농촌::農村のうそん
농도::濃度のうど
농민::農民のうみん
농약::農薬のうやく
능률::能率のうりつ
처마::軒のき
톱::のこぎり
바람, 소망::望みのぞみ
오름, 올라감::上りのぼり
장소, 곳, 자리, 경우::場ば
재::灰はい
배치::配置はいち
매점::売店ばいてん
매매::売買ばいばい
배열::配列はいれつ
무덤::墓はか
박사::博士はかせ
저울::はかり
구역질::吐き気はきけ
백지::白紙はくし
박물관::博物館はくぶつかん
톱니바퀴::歯車はぐるま
가위::はさみ
파산::破産はさん
사다리::はしご
기둥::柱はしら
비스듬함, 경사::はす
기, 깃발::旗はた
알몸, 맨몸::裸はだか
내의, 속옷::肌着はだぎ
일함, 활약, 활동, 작용, 기능::働きはたらき
발간::発刊はっかん
벌금::罰金ばっきん
발언::発言はつげん
발차::発車はっしゃ
신부, 새색시::花嫁はなよめ
날개, 깃::羽はね
용수철, 스프링::ばね
폭, 너비::幅はば
말이 빠름::早口はやくち
배, 복부::腹はら
철사::針金はりがね
반경::半径はんけい
도장::判子はんこ
반항::反抗はんこう
만세::万歳ばんざい
판사::判事はんじ
만전::万全ばんぜん
번지::番地ばんち
반도::半島はんとう
범인::犯人はんにん
반발::反発はんぱつ
볕이 듦, 양지::日当たりひあたり
응달, 음지::日陰ひかげ
뺄셈, 계산::引き算ひきざん
비김, 무승부::引き分けひきわけ
비행::飛行ひこう
무릎::ひざ
햇살, 햇볕::日差し・陽射しひざし
팔꿈치::ひじ
비상, 긴급사태::非常ひじょう
이마::額ひたい
필기::筆記ひっき
일자, 날짜::日付ひづけ
필자::筆者ひっしゃ
필수품::必需品ひつじゅひん
필수::必須ひっす
필적::匹敵ひってき
부정::否定ひてい
붐빔, 북적임::人込みひとごみ
사람의 왕래::人通りひとどおり
눈동자, 동공::瞳ひとみ
잠깐 쉼::一休みひとやすみ
혼잣말, 독백::独り言ひとりごと
한 사람 한 사람, 개개인::一人一人ひとりひとり
비난::非難ひなん
피난::避難ひなん
날, 날짜::日にちひにち
일몰, 해넘이::日の入りひのいり
일출, 해돋이::日の出ひので
울림::響きひびき
백과사전::百科事典ひゃっかじてん
표지::表紙ひょうし
표준::標準ひょうじゅん
표정::表情ひょうじょう
병세::病状びょうじょう
평등::平等びょうどう
병자, 환자::病人びょうにん
표본::標本ひょうほん
평론::評論ひょうろん
피로::疲労ひろう
넓이::広さひろさ
광장::広場ひろば
품격, 품질::品ひん
병::瓶びん
나름, 이동수단::便びん
품질::品質ひんしつ
편지지::便せんびんせん
병조림::瓶詰めびんづめ
풍선, 기구::風船ふうせん
봉투::封筒ふうとう
불운::不運ふうん
피리::笛ふえ
옳지 않음, 불가능, 불합격::不可ふか
무기::武器ぶき
불황::不況ふきょう
불균형::不均衡ふきんこう
부사::副詞ふくし
복사::複写ふくしゃ
자루, 주머니::袋ふくろ
불경기::不景気ふけいき
불행::不幸ふこう
부호, 표시::符号ふごう
부처, 부부::夫妻ふさい
부재::不在ふざい
마디, 절::節ふし
무사::武士ぶし
부상::負傷ふしょう
맹장지::ふすま
부정, 비리::不正ふせい
부속::付属ふぞく
쌍둥이::双子ふたご
가장자리, 테두리::縁ふち
부착::付着ふちゃく
불통, 두절::不通ふつう
물질::物質ぶっしつ
물리::物理ぶつり
붓::筆ふで
부동, 확고함::不動ふどう
부동산::不動産ふどうさん
선편, 배편::船便ふなびん
부모::父母ふぼ
무용::舞踊ぶよう
고향::ふるさと
분위기::雰囲気ふんいき
분화::噴火ふんか
분할::分割ぶんかつ
문예::文芸ぶんげい
문헌::文献ぶんけん
문체::文体ぶんたい
분배::分配ぶんぱい
분포::分布ぶんぷ
분별::分別ぶんべつ
문맥::文脈ぶんみゃく
문명::文明ぶんめい
분류::分類ぶんるい
담::塀へい
폐회::閉会へいかい
평행::平行へいこう
병대, 군대, 병사::兵隊へいたい
평야::平野へいや
배꼽::へそ
별관::別館べっかん
변환::変換へんかん
변속::変速へんそく
법, 법률::法ほう
몽둥이, 막대기::棒ぼう
방영::放映ほうえい
망원경::望遠鏡ぼうえんきょう
법학::法学ほうがく
비, 빗자루::ほうき
법규::法規ほうき
스님, 중을 친숙하게 부름::坊さんぼうさん
방지::防止ぼうし
방식::方式ほうしき
포장::舗装ほそう
방송국::放送局ほうそうきょく
법칙::法則ほうそく
붕대::包帯ほうたい
식칼::包丁ほうちょう
방정식::方程式ほうていしき
방범::防犯ぼうはん
볼, 뺨::頬ほお・ほほ
목장::牧場ぼくじょう
목축::牧畜ぼくちく
보험::保険ほけん
보호::保護ほご
보행::歩行ほこう
먼지::ほこり
자랑, 긍지::誇りほこり
북극::北極ほっきょく
도련님, 도령::坊ちゃんぼっちゃん
부처, 불상::仏ほとけ
불꽃, 불길::炎ほのお
수로, 해자::堀ほり
넝마, 누더기::ぼろ
쟁반::盆ぼん
본격::本格ほんかく
본관::本館ほんかん
본국::本国ほんごく
본질::本質ほんしつ
본체::本体ほんたい
분지::盆地ぼんち
본부::本部ほんぶ
본문::本文ほんぶん
본래::本来ほんらい
사이, 간격::間ま
미아::迷子まいご
매수, 장수::枚数まいすう
막, 천막::幕まく
마찰::摩擦まさつ
대합실::待合室まちあいしつ
맨 앞, 맨 먼저::真っ先まっさき
합침, 통합, 정리::まとまと
정리, 수습::まとめ
눈꺼풀::まぶた
길을 돌아서 감::回り道まわりみち
만석, 만원::満席まんせき
초승달::三日月みかづき
갑, 곶::みさき
수영복::水着みずぎ
점포, 가게::店屋みせや
꿀::蜜みつ
미정::未定みてい
신분, 지위::身分みぶん
미만::未満みまん
신분, 신원::身元みもと
매력::魅力みりょく
민간::民間みんかん
민요::民謡みにょう
무시::無視むし
민무늬::無地むじ
충치::虫歯むしば
가슴, 마음::胸むね
자색, 보랏빛::紫むらさき
싹::芽め
명작::名作めいさく
명시::明示めいじ
명인, 명수::名人めいじん
명물::名物めいぶつ
잠을 깸::目覚ましめざまし
밥, 식사::飯めし
아랫사람::目下めした
안표, 표시, 표지::目印めじるし
현기증::めまい
목표, 기준::目安めやす
면, 무명::綿めん
면세::免税めんぜい
면적::面積めんせき
변명, 해명::申し訳もうしわけ
목재, 재목::木材もくざい
목차, 차례::目次もくじ
떡::餅もち
소지품, 소유물::持ち物もちもの
처음, 기원::元もと
헛간, 광::物置ものおき
문답, 묻고 답함::問答もんどう
주전자::やかん
야간::夜間やかん
역, 번역::訳やく
직무, 역할::役やく
배우, 광대::役者やくしゃ
배우가 배역에 대해 연구함::役作りやくづくり
약품::薬品やくひん
화상, 뎀::やけど
야행::夜行やこう
화살표::矢印やじるし
집주인, 가장::家主やぬし
밤, 밤중::夜分やぶん
유원지::遊園地ゆうえんち
석간::夕刊ゆうかん
우호::友好ゆうこう
우정::友情ゆうじょう
우선::優先ゆうせん
우체국::郵便局ゆうびんきょく
여름철에 입는 무명 홑옷, 유카타::浴衣ゆかた
김, 수증기::湯気ゆげ
수혈::輸血ゆけつ
수송::輸送ゆそう
수입::輸入ゆにゅう
손끝, 발끝::指先ゆびさき
새벽, 새로운 시대의 시작::夜明けよあけ
용어::用語ようご
요지::要旨ようし
유아::幼児ようじ
유치원::幼稚園ようちえん
요점::要点ようてん
영양분::養分ようぶん
양모, 양털::羊毛ようもう
요령::要領ようりょう
예기, 예상::予期よき
욕실::浴室よくしつ
네 모퉁이, 교차로::四つ角よつかど
술주정꾼, 취객::酔っ払いよっぱらい
예비::予備よび
여분::余分よぶん
예보::予報よほう
읽을거리::読み物よみもの
며느리::嫁よめ
이해, 득실, 손익::利害りがい
육지, 뭍::陸りく
이혼::離婚りこん
이점::利点りてん
이면, 뒷면::裏面りめん
유역::流域りゅういき
유통::流通りゅうつう
양측::両側りょうがわ
고기잡이, 어부::漁師りょうし
양심::良心りょうしん
양립::両立りょうりつ
여객::旅客りょかく、りょきゃく
여권::旅券りょけん
이륙::離陸りりく
임시::臨時りんじ
영점, 빙점::零点れいてん
연합::連合れんごう
연상::連想れんそう
초, 양초::ろうそく
일본어와 영어::和英わえい
겨드랑이, 옆::わき
목화, 솜::綿わた
일본 옷::和服わふく
나눗셈::割り算わりざん
만, 바다가 육지로 굽어 후미진 곳::湾わん
부채질하다, 부치다::あおぐ
맛보다, 경험하다::味わうあじわう
따뜻해지다::温まる／暖まるあたたまる
난폭하게 굴다, 날뛰다::暴れるあばれる
잘못하다, 실수하다::過つあやまつ
저술하다, 저작하다::著すあらわす
싫어하다::嫌がるいやがる
볶다, 지지다::いる
굶주리다::飢えるうえる
뜨게 하다, 띄우다, 떠올리다, 생각해 내다::浮かべるうかべる
받다, 듣다, 맡다의 겸양어::承るうけたまわる
발사하다, 쏘다::撃つうつ
비치게 하다, 투영하다::映すうつす
빼앗다::奪ううばう
메워지다, 막히다::埋まるうまる
존경하다, 공경하다::敬ううやまう
점치다::占ううらなう
원망하다, 분하게 여기다::恨むうらむ
그리다, 묘사하다::描くえがく
범하다, 어기다::犯すおかす
공손히 절하다, 배례하다::拝むおがむ
늦추다::遅らすおくらす
억누르다::押さえるおさえる
납입되다, 납부되다::納まるおさまる
수습되다, 해결되다::収まるおさまる
두려워하다, 무서워하다::恐れるおそれる
으르다, 위협하다::おどかす
이르다, 미치다, 달하다, 할 수 있다, 이루어지다::及ぶおよぶ
내리다, 내려가다::下りるおりる
내리다, 내려뜨리다, 내리게 하다::降ろすおろす
도매로 팔다::卸すおろす
돌려보내다::帰すかえす
대신하다, 대용하다, 바꾸다::代えるかえる
되돌아가다, 되돌아오다::返るかえる
관계되다, 상관하다::かかわる
제한하다, 한정하다::限るかぎる
냄새 맡다::かぐ
숨다, 숨어있다::隠れるかくれる
부과하다, 시키다::課するかする
굳다, 딱딱해지다::固まるかたまる
조롱하다, 놀리다::からかう
베다, 깎다::刈るかる
귀여워하다::かわいがる
대신하다, 대리하다::代わるかわる
잘게 썰다, 새기다::刻むきざむ刻きざんだネギ 
싫어하다::嫌うきらう
떨어지다, 다 되다::切れるきれる
썩다, 상하다, 부패하다::腐るくさる
내려가다, 내려오다::下るくだる
푸다, 퍼 올리다::汲むくむ
미치다, 이상해지다::狂うくるう
가해지다, 더해지다, 늘다::加わるくわわる
발로 차다, 걷어차다::蹴るける
눌리다, 태우다::焦がすこがす
얼다, 추위로 곱다::凍えるこごえる
마련하다, 만들다::こしらえる
어렵게 하다, 악화시키다::こじらせる問題もんだいを拗こじらせる 風邪かぜを拗こじらせて肺炎はいえんになる 
넘다, 건너다, 이사하다::越すこす
굴리다, 쓰러뜨리다::転がすころがす
내리다, 숙이다::下げるさげる
박히다, 찔리다::刺さるささる
꽃다, 끼우다::挿すさす
방해하다::妨げるさまたげる
식다::冷めるさめる
떠나다, 사라지다, 지나다::去るさる
시끄럽게 하다, 떠들석하게 만들다::騒がすさわがす
초목이 무성하다::茂るしげる
조용해지다, 가라앉다, 안정되다::静まるしずまる
시들다, 오므라들다::しぼむ
웅크리다, 쭈그리다::しゃがむ
입에 넣고 빨다::しゃぶる
바람을 쐬다::涼むすずむ
비켜 놓다::ずらす
인쇄하다, 찍다::刷るする
어긋나다, 틀어져 맞지 않다, 벗어나다::ずれるピントがずれてぼやけた写真しゃしん 
꼭 붙어있다, 더해지다::添うそう
흘러 들어가다, 쏟아지다::注ぐそそぐ
깎다, 면도하다::そる
빗나가다, 벗어나다, 본래의 목적에서 일탈하다::逸れるそれる
알다, 생각하다의 겸양어::存じる・存ずるぞんじる・ぞんずる
쓰러지다, 넘어가다::倒れるたおれる
경작하다, 일구다::耕すたがやす
두드리다, 치다, 때리다::叩くたたく
출발하다, 떠나다::発つたつ
입을 다물다::黙るだまる
시험하다, 실제로 해보다::試すためす
충분하다, 족하다::足るたる
맹세하다, 서약하다, 굳게 결의하다::誓うちかう永遠えいえんの愛あいを誓ちかう 出陣しゅつじん式しきで必勝ひっしょうを誓ちかった選手せんしゅたち 
굳게 약속하다, 장래를 약속하다::契るちぎる
주름지다, 오그라들다::縮れるちぢれる
흩뜨리다, 어지르다::散らすちらす
떨어지다, 꽃잎이 지다::散るちる
붙잡히다::捕まるつかまる
쥐다, 붙잡다::つかむ
찌르다, 내지르다, 충전하다::突くつく
자리에 오르다, 취임하다::就くつく
쏟다, 붓다, 따르다::注ぐつぐ
뒤를 잇다, 버금가다::次ぐつぐ冷害れいがいに次つぐ冷害れいがい 社長しゃちょうに次つぐ実力じつりょく者しゃ 
찌부러지다, 깨지다::つぶれる
강해지다, 세지다::強まるつよまる
강하게 하다, 세게 하다::強めるつよめる
매달다::つる
달아매다, 매달다, 걸다::つるす
알맞다, 적당하다::適するてきする
묻다, 질문하다::問うとう
통과시키다::通すとおす
녹이다, 풀다, 금속을 가열하여 녹이다::溶かすとかす
뾰족해지다, 예민해지다::尖るとがる
풀다, 개다, 녹이다::溶くとく
물러나다, 비키다::どく
녹다, 풀리다::溶けるとける
풀리다, 끌러지다::解けるとける
치우다, 비키다, 물리치다::退けるどける
머물다, 움직이지 않다::とどまる
인접하다, 이웃하다::隣るとなる
날리다, 날게 하다::飛ばすとばす
묵게 하다, 숙박시키다::泊めるとめる
잡다, 포획하다::捕るとる
세게 때리다, 세게 치다::殴るなぐる
만들다, 이루다::成すなす
게으름 피우다::怠けるなまける
소리를 내다, 울리다::鳴らすならす
삶아지다, 익다::煮えるにえる
냄새가 나다, 향기가 나다::におる
놓아주다, 놓치다::逃がすにがす
쏘아보다, 노려보다::にらむ凄すごい目めで睨にらむ 
삶다, 익히다::煮るにる
적시다::濡らすぬらす
눕히다, 재우다::寝かす／寝かせるねかす・せかせる
비틀다, 쥐어짜다::ねじる
뜨거워지다, 가열하다, 뜨겁게 하다::熱するねっする
엿보다, 들여다보다::のぞく
바라다, 소망하다, 기대하다::望むのぞむ
연장시키다, 연기하다::延ばすのばす
오르다, 상경하다::上るのぼる
기다::這うはう
쓸다, 청소하다::掃くはく
토하다, 내뱉다::吐くはく
틈새에 끼이다, 사이에 끼이다::挟まるはさまるハムの挟はさまったサンドイッチ 二人ふたりの間あいだに挟はさまれて苦労くろうする 
끼우다, 사이에 두다::挟むはさむ
벌주다, 처벌하다::罰するばっする
놓이다, 풀리다::放れるはなれる
뛰어 오르다, 튀다::跳ねるはねる
서두르다, 앞당기다::早めるはやめる
속도를 높이다::速めるはやめる
유행하다, 인기가 있다::流行るはやる
임신하다, 품다, 내포하다::はらむ
뻗다, 부풀다, 붙이다, 바르다::張るはる
돌리다, 꼬집다, 비틀다::ひねる
펼치다, 넓히다::広げるひろげる
넓히다, 퍼뜨리다::広めるひろめる
늘다, 번식하다::殖えるふえる
부풀게 하다, 부풀리다::膨らますふくらます
부풀어 오르다, 불룩해지다::膨らむふくらむ
깊어지다, 이슥해지다::更けるふける
농하다, 까불다::ふざける
지나다, 경유하다::経るへる
집어 던지다, 내팽개치다::ほうる
감다, 말다::巻くまく
섞이다::混じる・交じるまじる
섞다, 합치다, 교차시키다::交えるまじえる
넣어 섞다, 혼합하다::混ぜるまぜる
타 넘다, 건너다, 걸치다::またぐ
제사 지내다, 모시다::祭るまつる
하나로 정리되다, 합쳐지다::まとまる
하나로 정리하다, 합치다::まとめる
둥글게 하다::丸めるまるめる
채우다, 충족시키다::満たすみたす
가득 차다::満ちるみちる
보다, 진찰하다::診るみる
향하다, 돌리다::向けるむける
무덥다, 찌다::蒸すむす
명하다::命じる・命ずるめいじる・めいずる
은혜를 베풀다, 인정을 베풀다::恵むめぐむ
돌다, 순회하다, 둘러싸다::巡るめぐる
벌이가 되다, 덕을 보다::儲かるもうかる儲もうかる商売しょうばい 
벌다, 이익을 보다::儲けるもうける
잠수하다, 숨어들다::潜るもぐる
비비다, 문지르다, 주무르다::もむ
불태우다::燃やすもやす
그릇에 많이 담다, 쌓아 올리다, 담다::盛るもる
번역하다, 해석하다::訳すやくす
찢다::破くやぶく
술에 취하다, 멀미하다::酔うよう
더럽히다::汚すよごす
중지하다, 그만두다::止すよす
기인하다, 원인이 되다::因るよる
기쁘게 하다::喜ばせるよろこばせる
약화시키다::弱めるよわめる
파르스름하다, 창백하다::青白いあおじろい
성글다, 거칠다, 조잡하다::粗いあらい
애처롭다, 가엾다::痛ましいいたましい
얌전하다, 점잖다::大人しいおとなしい
무겁다, 묵직하다, 답답하다::重たいおもたい重おもたい石いし 気分きぶんが重おもたい 
딱딱하다, 단단하다::硬いかたい
굳건하다, 견고하다, 확고하다::堅いかたい堅かたい鉛筆えんぴつ 堅かたい団結だんけつ 
가렵다::かゆい
맑다, 깨끗하다::清いきよい
하찮다, 시시하다::くだらない
시끄럽다, 떠들썩하다::騒がしいさわがしい
짜다::塩辛いしおからい
네모지다, 각지다::四角いしかくい
뻔뻔스럽다, 낯두껍다::ずうずうしい
시다, 시큼하다::すっぱい
갈색이다::茶色いちゃいろ
아주 오래다, 영원하다::永いながい
밉살스럽다, 얄밉다::憎らしいにくらしい
졸리다::眠たいねむたい
느리다, 둔하다::のろい
어리석다, 시시하다, 어이없다::ばからしい
아주 심하다, 대단하다::甚だしいはなはだしい
새하얗다::真っ白いまっしろい
추하다, 보기 흉하다::みにくい
경사스럽다, 축하할 만하다::めでたいめでたい日ひ おめでたい事ことが続つづく 
아주 귀찮다, 몹시 성가시다::面倒臭いめんどうくさい
변명의 여지가 없다::申し訳ないもうしわけない
아깝다, 과분하다::もったいない
굉장하다, 아주 무섭다::ものすごい
값싸다, 싸구려 같다::安っぽいやすっぽい
어려 보이다, 생기발랄하다::若々しいわかわかしい
세상에 흔히 있음, 있기 쉬움::ありがちそういう失敗しっぱいは有あり勝がちなことだ 
몸집이 큼, 모양이 큼::大柄おおがら
대략적임, 조잡함::おおざっぱ
멋을 냄, 멋쟁이임::おしゃれ
같음, 똑같음::同じおなじ
과격함::過激かげき
간략함::簡略かんりゃく
기민함, 민첩함::機敏きびん
강력함::強力きょうりょく
구체적임::具体的ぐたいてき
인색함, 쩨쩨함::けち金持かねもちの癖くせに、けちだ 
품위가 없음::下品げひん
겸허함::謙虚けんきょ
고급스러움::高級こうきゅう
긍정적임::肯定的こうていてき
고등함, 수준이 높음::高等こうとう
공평함::公平こうへい
곤란함::困難こんなん
거꾸로 됨, 반대로 됨::逆さ・逆様さかさ・さかさま
자그마함, 사소함, 조촐함::ささやか細ささやかな家いえ 細ささやかな心こころづくし 
상쾌함, 시원함::さわやか
빈번함, 계속됨::しきり
실용적임::実用的じつようてき
순수함::純粋じゅんすい
소극적임::消極的しょうきょくてき
상등, 고급임, 훌륭함::上等じょうとう
정확함::正確せいかく
정당함::正当せいとう
절대적임::絶対的ぜったいてき
아주 좋음, 더 없이 좋음::絶好調ぜっこうちょう
전국적임::全国的ぜんこくてき
선명함::鮮明せんめい
대등함, 동등함::対等たいとう
평평함, 평탄함::平らたいら平たいらな道みち 
다난함::多難たなん
어쩌다가 있음, 아주 드묾::たま
다양함::多様たよう
단조로움::単調たんちょう
지적임::知的ちてき
착실함::着実ちゃくじつ
적확함, 정확함::的確・適格てきかく
울퉁불퉁함, 불균형함::凸凹でこぼこ凸凹でこぼこの土地とち 凸凹でこぼこな成績せいせき 
알맞음, 적당함, 다루기에 알맞음::手頃てごろ
동일함, 같음::同一どういつ
투명함::透明とうめい
특별함::特別とくべつ
둔감함::鈍感どんかん
경사짐, 비스듬함, 바르지 않음, 부정::斜めななめ
건방짐, 주제넘음::生意気なまいき
매끄러움, 순조로움::滑らかなめらか
연약함, 무르고 약함::軟弱なんじゃく
태평함, 느긋함::のんき
막대함::莫大ばくだい
불결함, 더러움::不潔ふけつ
자유롭지 못함, 불편함::不自由ふじゆう
불필요함::不要ふよう
불리함::不利ふり
불량함::不良ふりょう
평범함::平凡へいぼん
우그러진 모양, 배가 몹시 고픈 모양::ぺこぺこ
방대함, 막대함::膨大ぼうだい
너덜너덜함::ぼろぼろ
진심임, 진지함::本気ほんき
비참함, 참혹함::惨めみじめ惨みじめな生活せいかつ 
무한함::無限むげん
무수함::無数むすう
무력함::無力むりょく
아주, 엄청::めちゃくちゃ
용감함::勇敢ゆうかん
유능함::有能ゆうのう
유유, 느긋함, 아득히 멈::悠々ゆうゆう悠々ゆうゆうと泳およぎ去さる 悠々ゆうゆうたる大空おおぞら 
완만함, 느슨함, 느긋함::緩やかゆるやか
양호함::良好りょうこう
빈 깡통::空き缶あきかん
빈 방::空き部屋あきべや
악순환::悪循環あくじゅんかん
악감정::悪感情あくかんじょう
악취미::悪趣味あくしゅみ
이튿날 아침::あくる朝あくるあさ
이듬해, 다음 해::あくる年あくるとし
다음날, 이튿날::あくる日あくるひ
어떤 사람::ある人あるひと
어느 날::ある日あるひ
어느 곳::ある所あるところ
다른 업종::異業種いぎょうしゅ
이민족::異民族いみんぞく
이국, 외국::異国いこく
며칠::幾日いくにち
몇 명::幾人いくにん
몇 천만::幾千万いくせんまん
한 음악가::一音楽家いちおんがくか
한 사회인::一社会人いちしゃかいじん
한 신문기자::一新聞記者いちしんぶんきしゃ
일시, 한 때::一時いちじ
일종::一種いっしゅ
일안, 하나의 제안::一案いちあん
지저분하다::薄汚いうすぎたない
희미함::薄ぼんやりうすぼにゃり
몹시 서두름::大急ぎおおいそぎ
큰 소동::大騒ぎおおさわぎ
큰 화재::大火事おおかじ
옥체::御身おんみ
각 선수::各選手かくせんしゅ
각 가정::各家庭かくかてい
각 방면::各方面かくほうめん
가계약::仮契約かりけいやく
가처분::仮処分かりしょぶん
가제본::仮製本かりせいほん
역회전::逆回転ぎゃくかいてん
역효과::逆効果ぎゃくこうか
역차별::逆差別ぎゃくさべつ
구체제::旧体制きゅうたいせい
옛 식민지::旧植民地きゅうしょくみんち
음력설::旧正月きゅうしょうがつ
급상승::急上昇きゅうじょうしょう
급커브::急カーブきゅうカーブ
극작가::劇作家げきさっか
극영화::劇映画げきえいが
극 대본::劇台本げきだいほん
현시점::現時点げんじてん
현 정부::現政府げんせいふ
현 주소::現住所げんじゅうしょ
말쑥함, 깔끔함, 조촐함::小ぎれいこぎれい小綺麗こぎれいな服装ふくそう 
추레하다, 꾀죄죄하다::小汚いこぎたない
고기압::高気圧こうきあつ
고혈압::高血圧こうけつあつ
호경기, 호황::好景気こうけいき
형편, 상황이 좋음::好都合こうつごう
좋은 조건::好条件こうじょうけん
이번 대회::今大会こんたいかい
이번 시즌::今シーズンこんシーゼン
이번 계절, 이번 시즌::今季こんき
재발행::再発行さいはっこう
재검사::再検査さいけんさ
재평가::再評価さいひょうか
최고급::最高級さいこうきゅう
최후미, 맨 뒤::最後尾さいこうび
최신작::最新作さいしんさく
지난 시즌::昨シーズンさくシーズン
시운전, 시운행::試運転しうんてん
시착, 입어봄::試着しちゃく
시음::試飲しいん
주산지::主産地しゅさんち
주목적::主目的しゅもくてき
주전원::主電源しゅでんげん
중노동::重労働じゅうろうどう
중공업::重工業じゅうこうぎょう
중금속::重金属じゅうきんぞく
순 국산::純国産じゅんこくさん
순수 문학::純文学じゅんぶんがく
준회원::準会員じゅんかいいん
준준결승::準準決勝じゅんじゅんけっしょう
준공무원::準公務員じゅんこうむいん
여러 조건::諸条件しょじょうけん
여러 사정::諸事情しょじじょう
여러 단체::諸団体しょだんたい
첫 대면, 첫 만남::初対面しょたいめん
초연::初演しょえん
초여름::初夏しょか
조감독::助監督じょかんとく
조동사::助動詞じょどうし
적은 자금::小資金しょうしきん
소논문::小論文しょうろんぶん
소도시::小都市しょうとし
매우 좋은 기분::上機嫌じょうきげん
신상품::新商品しんしょうひん
신기록::新記録しんきろく
그대로 지나침::素通りすどおり
잠만 자는 숙박::素泊まりすどまり
맨 얼굴::素顔すがお
전 시장::前市長ぜんしちょう
전근대적::前近代的ぜんきんだいてき
전년도::前年度ぜんねんど
전 국민::全国民ぜんこくみん
전체 학생::全学生ぜんがくせい
총선거::総選挙そうせんきょ
총수입::総収入そうしゅうにゅう
총결산::総決算そうけっさん
다기능::多機能たきのう
다방면::多方面たほうめん
다목적::多目的たもくてき
대미 수출::対米輸出たいべいゆしゅつ
대유럽 무역::対欧州貿易たいおうしゅうぼうえき
대환영::大歓迎だいかんげい
대규모::大規模だいきぼ
대성공::大成功だいせいこう
저자세::低姿勢ていしせい
저기압::低気圧ていきあつ
저성장::低成長ていせいちょう
동시대::同時代どうじだい
같은 형식::同形式どうけいしき
같은 문제::同問題どうもんだい
생방송::生放送なまほうそう
생맥주::生ビールなまビール
라이브 연주::生演奏なまえんそう
반사회적::反社会的はんしゃかいてき
반정부::反政府はんせいふ
반체제::反体制はんたいせい
반영구적::半永久的はんえいきゅうてき
반소매, 반팔::半そではんそで
반자동::半自動はんじどう
비상식, 몰상식함::非常識ひじょうしき
비과학적::非科学的ひかがくてき
비공개::非公開ひこうかい
한 줌::一握りひとにぎり
한판 승부::一勝負ひとしょうぶ
불공평함::不公平ふこうへい
사양하지 아니함::無遠慮ぶえんりょ
부위원장::副委員長ふくいいんちょう
부작용::副作用ふくさよう
부수입::副収入ふくしゅうにゅう
헌책방::古本屋ふるほんや
헌 신문::古新聞ふるしんぶん
헌 옷::古着ふるぎ
다른 문제::別問題べつもんだい
별세계::別世界べっせかい
다른 행동::別行動べつこうどう
본 제품::本製品ほんせいひん
본 건축::本建築ほんけんちく
본 사건::本事件ほんじけん
바로 정면::真正面ましょうめん
바로 위::真上まうえ
새빨감::真っ赤まっか
미완성::未完成みかんせい
미공개::未公開みこうかい
미해결::未解決みかいけつ
명년, 내년::明年みょうねん
명조, 내일 아침::明朝みょうちょう
내년 봄::明春みょうしゅん
전 수상::元首相もとしゅしょう
전 대통령::元大統領もとだいとうりょう
전 남자친구::元彼もとかれ
검토가 필요함::要検討ようけんとう
요주의::要注意ようちゅうい
내년 여름::来夏らいか
내년도::来年度らいねんど
양손::両手りょうて
양 진영, 두 진영::両陣営りょうじんえい
양극단::両極端りょうきょくたん
일본식 과자::和菓子わがし
일식::和食わしょく
우리 학교::我が校わがこう
우리회사::我が社わがしゃ
우리 집::我が家わがや
인류애::人類愛じんるいあい
동성애::同性愛どうせいあい
모성애::母性愛ぼせいあい
휴가 직후::休み明けやすみあけ
장마가 끝난 직후::梅雨明けつゆあけ
다음 달쯤::来月あたりらいげつあたり
작년쯤::去年あたりきょねんあたり
개혁안::改革案かいかくあん
타협안::妥協案だきょうあん
예산안::予算案よさんあん
반대파 일색::反対派一色はんたいはいっしょく
월드컵 일색::ワールドカップ一色ワールドカップいっしょく
일본 제일::日本一にほんいち
세계 최고::世界一せかいいち
전국 최고::全国一ぜんこくいち
소화액::消化液しょうかえき
수용액::水溶液すいようえき
부동액::不凍液ふとうえき
동물원::動物園どうぶつえん
식물원::植物園しょくぶつえん
한 사람 걸러::一人おきにひとりおきに
일주일 간격으로::一週間おきにいっしゅうかんおきに
영양가::栄養価えいようか
판매가::販売かはんばいか
진가::真価しんか
감독하::監督下かんとくか
지배하::支配下しはいか
관할하::管轄下かんかつか
수채화::水彩画すいさいが
영화계::映画界えいがかい
예능계::芸能界げいのうかい
교육계::教育界きょういくかい
번화가::繁華街はんかがい
관청가::官庁街かんちょうがい
암흑가::暗黒街あんこくがい
문제 밖::問題外もんだいがい
영역 외::領域外りょういきがい
예정 밖::予定外よていがい
회계 담당::会計係かいけいがかり
출납계::出納係すいとうがかり
접대 담당::接待係せったいがかり
한도액::限度額げんどがく
목표액::目標額もくひょうがく
차액::差額さがく
하고 있는 중임, 하다 맒::やり掛けやりかけ仕事しごとをやり掛かけにしたまま出でかける やり掛かけの仕事しごと 
읽다 맒::読み掛けよみかけ
쓰다 맒::書き掛けかきかけ
선생님들::先生方せんせいがた
여러분들::あなた方あなたがた
최신형::最新型さいしんがた
노력형::努力型どりょくがた
천재형::天才型てんさいがた
가치관::価値観かちかん
인생관::人生観じんせいかん
역사관::歴史観れきしかん
호흡기::呼吸器こきゅうき
세면기, 세면대::洗面器せんめんき
사진기::写真機しゃしんき
발전기::発電機はつでんき
탐지기::探知機たんちき
반에서 제일 가는::クラスきっての
야구계에서 제일 가는::野球界きってのやきゅうかいきっての
오를 기미::上がり気味あがりぎみ
초조해하는 기색::焦り気味あせりぎみ
기독교::キリスト教キリストきょう
불교::仏教ぶっきょう
이슬람교::イスラム教イスラムきょう
제조업::製造業せいぞうぎょう
건축업::建築業けんちくぎょう
판매업::販売業はんばいぎょう
재고 없음::在庫ぎれざいこぎれ
시간이 다 됨::時間切れじかんぎれ
들어가려고 할 때::入り際いりぎわ
관용구::慣用句かんようく
삽입구::挿入句そうにゅうく
정형구::定型句ていけいく
비상구::非常口ひじょうぐち
통용 출입구::通用口つうようぐち
혁명군::革命軍かくめいぐん
정부군::政府軍せいふぐん
반란군::反乱軍はんらんぐん
장군의 집안::将軍家しょうぐんけ
야마모토의 집안::山本家やまもとけ
무가, 무사 집안::武家ぶけ
은하계::銀河系ぎんがけい
태양계::太陽系たいようけい
외자계, 외국계::外資系がいしけい
시대극::時代劇じだいげき
창작극::創作劇そうさくげき
인형극::人形劇にんぎょうげき
소유권::所有権しょゆうけん
지도권::指導権しどうけん
경영권::経営権けいえいけん
저장고::貯蔵庫ちょぞうこ
냉동고::冷凍庫れいとうこ
방과 후::放課後ほうかご
사후::事後じご
식후::食後しょくご
기계공::機械工きかいこう
수리공::修理工しゅうりこう
화공, 화가::画工がこう
무역항::貿易港ぼうえきこう
자유항::自由港じゆうこう
수출항::輸出港ゆしゅつこう
창간호::創刊号そうかんごう
선진국::先進国せんしんこく
공화국::共和国きょうわこく
강대국::強大国きょうだいこく
통째로::まるごと
껍질째::皮ごとかわごと
자동차 그대로::車ごとくるまごと
만나는 사람마다::会う人ごとにあうひとごとに
산막, 산장::山小屋やまごや
마구간::馬小屋うまごや
온도 차::温度差おんどさ
시간 차::時間差じかんさ
개인차::個人差こじんさ
학교 축제::学園祭がくえんさい
영화제::映画祭えいがさい
문화제::文化祭ぶんかさい
소비재::消費財しょうひざい
대체재::代替材だいたいざい
소독제::消毒剤しょうどくざい
수면제::睡眠剤すいみんざい
세정제::洗浄剤せんじょうざい
상해죄::傷害罪しょうがいざい
사기죄::詐欺罪さぎざい
협박죄::脅迫罪きょうはくざい
대표작::代表作だいひょうさく
최신작::最新作さいしんさく
데뷔작::デビュー作デビューさく
세계사::世界史せかいし
문학사::文学史ぶんがくし
고대사::古代史こだいし
비행사::飛行士ひこうし
변호사::弁護士べんごし
기관사::機関士きかんし
간호사::看護師かんごし
약제사::薬剤師やくざいし
사기꾼::詐欺師さぎし
확실시::確実視かくじつし
중요시::重要視じゅうようし
문제시::問題視もんだいし
회보지::会報誌かいほうし
졸업식::卒業式そつぎょうしき
성인식::成人式せいじんしき
결혼식::結婚式けっこんしき
최신식::最新式さいしんしき
충전식::充電式じゅうでんしき
구식::旧式きゅうしき
결정되는 대로::決まり次第きまりしだい
도착하는 대로::到着次第とちゃくしだい
연구실::研究室けんきゅうしうしつ
실험실::実験室じっけんしつ
면회실::面会室めんかいしつ
운전수::運転手うんてんしゅ
가수::歌手かしゅ
외야수::外野手がいやしゅ
일본주::日本酒にほんしゅ
과실주::果実酒かじつしゅ
양주::洋酒ようしゅ
문제집::問題集もんだいしゅう
용례집::用例集ようれいしゅう
사진집::写真集しゃしんしゅう
항해술::航海術こうかいじゅつ
최면술::催眠術さいみんじゅつ
점성술::占星術せんせいじゅつ
번호순::番号順ばんごうじゅん
연도순::年度順ねんどじゅん
선착순::先着順せんちゃくじゅん
시청::市役所しやくしょ
연구소::研究所けんきゅうじょ
정류소, 정류장::停留所ていりゅうじょ
신인상::新人賞しんじんしょう
노력상::努力賞どりょくしょう
우수상::優秀賞ゆうしゅうしょう
잡화상::雑貨商ざっかしょう
소매상::小売商しょうばいしょう
무역상::貿易商ぼうえきしょう
합병증::合併症がっぺいしょう
과민증::過敏症かびんしょう
꽃가루 알레르기::花粉症かふんしょう
학생증::学生証がくせいしょう
면허증::免許証めんきょしょう
등로긍::登録証とうろくしょう
역사상::歴史上れきしじょう
법률상::法律上ほうりつじょう
외관상::見かけ上みかけじょう
안내장::案内状あんあいじょう
고소장::告訴状こくそじょう
독촉장::催促状さいそくじょう
구형, 둥근 형태::球状きゅうじょう
액상, 액체 상태::液状えきじょう
경기장::競技場きょうぎじょう
자전거 주차장::駐輪場ちゅうりんじょう
보호색::保護色ほごしょく
지방색::地方色ちほうしょく
향토색::郷土色きょうどしょく
영양식::栄養食えいようしょく
기내식::機内食きないしょく
유동식::流動食りゅうどうしょく
관리직::管理職かんりしょく
사무직::事務職じむしょく
전문직::専門職せんもんしょく
주파수::周波数しゅうはすう
득표수::得票数とくひょうすう
학생수::学生数がくせいすう
해결됨::解決済みかいけつずみ
예약 완료::予約済みよやくずみ
소독 완료::消毒済みしょうどくずみ
유학생::留学生りゅうがくせい
연구생::研究生けんきゅうせい
벌금제::罰金生ばっきんせい
공화제::共和制きょうわせい
일관성::一貫性いっかんせい
유전성::遺伝性いでんせい
금연석::禁煙席きんえんせき
지정석::指定席していせき
조수석::助手席じょしゅせき
연장선::延長線えんちょうせん
국제 노선::国際線こくさいせん
전화선::電話線でんわせん
화물선::貨物船かもつせん
수송선::輸送船ゆそうせん
우주선::宇宙船うちゅうせん
연장전::延長戦えんちょうせん
결승전::決勝戦けっしょうせん
공중전::空中戦くうちゅうせん
도내 전체::都内全体とないぜんたい
지붕 전체::屋根全体やねぜんたい
경제 전반::経済全般けいざいぜんぱん
계획 전반::計画全般けいかくぜんぱん
강가::川沿いかわぞい
산기슭::山沿いやまぞい
해안가, 바닷가::海岸沿いかいがんぞい
지식층::知識層ちしきそう
독자층::読者層どくしゃそう
연령층::年齢層ねんれいそう
온실에서 자람::温室育ちおんしつそだち
외동딸로 자람::お嬢様育ちおじょうさまそだち
도쿄에서 자람::東京育ちとうきょうそだち
청년단::青年団せいねんだん
조사단::調査団ちょうさだん
선수단::選手団せんしゅだん
일등, 한 벌::一着いっちゃく
칠오조::七五調しちごちょう
복고조::復古調ふっこちょう
최고 상태, 아주 좋음::絶好調ぜっこうちょう
검찰청::検察庁けんさつちょう
수산청::水産庁すいさんちょう
국세청::国税庁こくぜいちょう
항공 요금::航空賃こうくうちん
뱃삯::船賃ふなちん
품삯::手間賃てまちん
헛되이 씀::無駄づかいむだづかい
말씨, 말투::言葉づかいことばづかい
경품이 딸림::景品付きけいひんつき
조건부 찬성::条件付きの賛成じょうけんつきのさんせい
영어 공부에 몰두::英語漬けえいごづけ
약물에 빠짐::薬漬けくすりづけ
골프에 빠짐::ゴルフ漬けゴルフづけ
읽기 어렵다::読みづらいよみづらい
말하기 어렵다::言いづらいいいづらい
쓰는 사람, 필자::書き手かきて
말하는 사람, 화자::語り手かたりて
듣는 사람, 청자::聞き手ききて
문제점::問題点もんだいてん
타협점::妥協点だきょうてん
작품전::作品展さくひんてん
사진전::写真展しゃしんてん
기획전::企画展きかくてん
위험도::危険度きけんど
지명도::知名度ちめいど
이해도::理解度りかいど
이웃끼리::近所同士きんじょどうし
이웃끼리::隣同士となりどうし
사촌끼리::いとこ同士いとこどうし
기간내::期間内きかんない
시간내::時間内じかんない
교실 안::教室内きょうしつない
경영난::経営難けいえいなん
자금난::資金難しきんなん
생활난::生活難せいかつなん
교육열::教育熱きょういくねつ
태양열::太陽熱たいようねつ
야구열::野球熱やきゅうねつ
연패::連敗れんぱい
석패::惜敗せきはい
런던발::ロンドン発ロンドンはつ
활자를 멀리함::活字離れかつじばなれ
이과를 기피함::理科離れりかばなれ
현행범::現行犯げんこうはん
살인범::殺人犯さつじんはん
지능범::知能犯ちのうはん
한정판::限定版げんていばん
개정판::改訂版かいていばん
최신판::最新版さいしんばん
게시판::掲示板けいじばん
광고판::広告板こうこくばん
번호판::番号板ばんごうばん
규격판::規格判きかくばん
명함판::名刺判めいしばん
연구비::研究費けんきゅうひ
생활비::生活費せいかつひ
교통비::交通費こうつうひ
심사평::審査評しんさひょう
인물평::人物評じんぶつひょう
호평::好評こうひょう
가격표::価格表かかくひょう
시각표::時刻表じこくひょう
예정표::予定表よていひょう
피부병::皮膚病ひふびょう
성인병::成人病せいじんびょう
직업병::職業病しょくぎょうびょう
유럽풍::ユーロッパ風ユーロッパふう
서양풍::洋風ようふう
흥미롭다::興味深いきょうみぶかい
주의 깊다::注意深いちゅういぶかい
우주복::宇宙服うちゅうふく
작업복::作業服さぎょうふく
체육복::体操服たいそうふく
음식물::飲食物いんしょくぶつ
간행물::刊行物かんこうぶつ
유실물::遺失物いしつぶつ
오랜만임::しばらくぶり
능력별::能力別のうりょくべつ
지방별::地方別ちほうべつ
직업별::職業別しょくぎょうべつ
금속편::金属片きんぞくへん
한 조각::一片いっぺん
일보, 한 걸음::一歩いっぽ
두 발짝::二歩にほ
첫걸음::第一歩だいいっぽ
국제법::国際法こくさいほう
요리법::料理法りょうりほう
해결법::解決法かいけつほう
사내보::社内報しゃないほう
주의보::注意報ちゅういほう
경보::警報けいほう
학기말::学期末がっきまつ
이달 말::今月末こんげつまつ
세기말::世紀末せいきまつ
현실성::現実味げんじつみ
인간미::人間味にんげんみ
진실성::真実味しんじつみ
흥행면::興行面こうぎょうめん
금전적인 면::金銭面きんせんめん
구성 면::構成面こうせいめん
제조원::製造元せいぞうもと
판매원::販売元はんばいもと
상담 역할::相談役そうだんやく
상대역::相手役あいてやく
사회자 역할::司会役しかいやく
그들::彼らかれら
그것들::それら
우리들::我らわれら
몇 해 전부터::年来ねんらい
지금까지::従来じゅうらい
성공리::成功裏せいこうり
암암리::暗々裏あんあんり
비밀리::秘密裏ひみつり
출생률::出生率しゅっせいりつ
치사율::致命率ちめいりつ
백분율, 퍼센트::百分率ひゃくぶんりつ
자기식::自己流じこりゅう
서양식::西洋流せいようりゅう
교통량::交通量こうつうりょう
식사량::食事量しょくじりょう
음량::音量おんりょう
프랑스령::フランス領フランスりょう
네덜란드령::オランダ領オランダりょう
경제력::経済力けいざいりょく
이해력::理解力りかいりょく
사고력::思考力しこうりょく
문방구류::文房具類ぶんぼうぐるい
시트류::シーツ類シーツるい
어패류::魚介類ぎょかいるい
수상 이력::受賞歴じゅしょうれき
지도 경력::指導歴しどうれき
선수 경력::選手歴せんしゅれき
활주로::滑走路かっそうろ
통학로::通学路つうがくろ
수송로::輸送路ゆそうろ
회의록::会議録かいぎろく
회상록::回想録かいそうろく
견문록::見聞録けんぶんろく
평화론::平和論へいわろん
역사론::歴史論れきしろん
이상론::理想論りそうろん
서로 치다, 서로 싸우다::相打つあいうつ
위를 보다::仰向くあおむく
맞추다, 적용시키다::当てはめるあてはめる
걸어다니다, 돌아다니다::歩き回るあるきまわる
바꿔 말하다::言い換えるいいかえる
명령하다, 고자질하다::言い付けるいいつける
뽐내다, 거만하게 굴다::威張るいばる
바꿔 넣다::入れ替えるいれかえる
접수하다, 받아들이다::受け付けるうけつける
수취하다, 받다::受け取るうけとる
맡다, 담당하다::受け持つうけもつ
옮겨 살다, 이주하다::移り住むうつりすむ
뒤집다::裏返すうらがえす
배반하다, 배신하다::裏切るうらぎる
판매하다, 출시하다::売り出すうりだす
상회하다::上回るうわまわる
돌려보내다, 쫓아내다::追い返すおいかえす
뒤쫓아가다::追い掛けるおいかける
앞지르다::追い越すおいこす
몰아넣다::追い込むおいこむ
내쫓다, 몰아내다::追い出すおいだす
굳게 결심하다, 믿다::思い込むおもいこむ
되돌아가다, 되돌아오다::折り返すおりかえす
사들이다::買い込むかいこむ
적어넣다, 기입하다::書き込むかきこむ
받아쓰다, 베껴 쓰다::書き取るかきとる
다시 쓰다, 고쳐 쓰다::書き直すかきなおす
생각나다::考え付くかんがえつく
되묻다, 다시 듣다::聞き返すききかえす
알아듣다::聞き取るききとる
되묻다, 다시 듣다::聞き直すききなおす
건성으로 듣다::聞き流すききながす
깨닫다, 알아차리다::気づくきづく
들러붙다::くっつく
붙이다::くっつける
조립하다::組み立てるくみたてる
알다, 납득하다::心得るこころえる
전언하다, 말을 전하다::言付けることづける
거슬러 올라가다::さかのぼる
빼다, 제하다::差し引くさしひく
하회하다, 밑돌다::下回るしたまわる
좁혀나가다::絞り込むしぼりこむ
믿어 의심치 않다::信じ込むしんじこむ
흡수하다, 빨아들이다::吸い取るすいとる
비쳐 보이다, 투명하다::透き通るすきとおる
스쳐 지나가다, 엇갈리다::すれ違うすれちがう
짊어지다, 업다::背負うせおう
일어서다, 일어나다::立ち上がるたちあがる
떠나다, 물러나다::立ち去るたちさる
멈추어 서다::立ち止まるたちどまる
접근하다, 다가가다::近寄るちかよる
다 써버리다::使い切るつかいきる
부닺치다, 충돌하다::突き当たるつきあたる
깊이 파고들다, 처넣다::突っ込むつっこむ
균형 잡히다, 어울리다::釣り合うつりあう
마중 나가다::出迎えるでむかえる
다시 묻다, 반문하다::問い返すといかえす
묻다, 질문하다::問いかけるといかける
마침 지나가다::通り掛かるとおりかかる
지나치다, 통과하다::通り過ぎるとおりすぎる
녹아 섞이다::溶け込むとけこむ
날아오르다, 날뛰다::飛び上がるとびあがる
뛰어내리다::飛び降りるとびおりる
뛰어넘다, 건너뛰다::飛び越えるとびこえる
뛰어들다, 투신하다::飛び込むとびこむ
뛰어나가다, 튀어나오다::飛び出すとびだす
날아가다, 날아오르다::飛び立つとびたつ
달려들다, 덤벼들다::飛び付くとびつく
뛰어 올라타다::飛び乗るとびのる
날아다니다::飛び回るとびまわる
맞잡다, 쟁탈하다::取り合うとりあう
집어 들다, 빼앗다::取り上げるとりあげる
취급하다, 처리하다::取り扱うとりあつかう
한데 모으다::取り集めるとりあつめる
거둬들이다, 받아들이다::取り入れるとりいれる
남겨두다, 보관하다::取り置くとりおく
지내다, 거행하다::執り行うとりおこなう
되찾다, 만회하다::取り返すとりかえす
바꾸다, 교환하다::取り替えるとりかえる
둘러싸다, 에워싸다::取り巻くとりまく
교환하다::取り交わすとりかわす
결정하다, 계약하다::取り決めるとりきめる
모조리 따다, 전부 뜯다::取り切るとりきる
취소하다::取り消すとりけす
혼잡하다, 거둬들이다::取り込むとりこむ
꺼내다, 골라 내다::取り出すとりだす
다시 하다, 새로이 하다::撮り直すとりなおす
되찾다, 회복하다::取り戻すとりもどす
그만두다, 중지하다::取り止めるとりやめる
나누다, 갈라놓다::取り分けるとりわける
오래 끌다, 질질 끌다::長引くながびく
갈아타다, 바꿔 타다::乗り換えるのりかえる
극복하다::乗り越えるのりこえる
뛰어다니다, 동분서주하다::走り回るはしりまわる
남은 돈을 돌려주다::払い戻すはらいもどす
팽팽하다, 힘을 내다::張り切るはりきる
떠맡다, 인수하다::引き受けるひきうける
끌어들이다::引き込むひきこむ
꺼내다, 끄집어내다::引き出すひきだす
뽑다, 선발하다::引き抜くひきぬく
걸리다, 걸려들다::引っ掛かるひっかかる
걸다::引っ掛けるひっかける
뒤집다, 뒤엎다::引っ繰り返すひっくりかえす
뒤집히다, 역전되다::引っ繰り返るひっくりかえる
매달리다, 늘어지다::ぶら下がるぶらさがる
매달다, 늘어뜨리다::ぶら下げるぶらさげる
행동하다::振る舞うふるまう
미소 짓다::微笑むほほえむ
흉내내다, 모방하다::真似るまねる
올려다보다, 쳐다보다::見上げるみあげる
발견되다, 눈에 띄다::見当たるみあたる
마주 보다, 대조하다::見合わせるみあわせる
찾아내다, 발견하다::見いだすみいだす
배웅하다, 바래다주다::見送るみおくる
간과하다, 못 보고 놓치다::見落とすみおとす
내려다보다, 얕보다::見下ろすみおろす
다시 보다, 뒤돌아보다::見返すみかえす
눈에 띄다, 가끔 보다::見かけるみかける
기대하다, 예상하다::見込むみこむ
얕보다, 업신여기다::見下げるみさげる
응시하다, 주시하다::見詰めるみつめる
다시 보다, 재검토하다::見直すみなおす
눈에 익다, 낯익다::見慣れるみなれる
병문안하다::見舞うみまう
분별하다, 분간하다::見分けるみわける
눈에 띄다, 두드러지다::目立つめだつ
들어 올리다, 쳐들다::持ち上げるもちあげる
기인하다, 바탕으로 하다::基づくもとづく
말하다, 이야기를 하다::物語るものがたる
불거지다, 고조되다::盛り上がるもりあがる
도움이 되다, 쓸모가 있다::役立つやくだつ
유용하게 쓰다::役立てるやくだてる
해치우다::やっつける
손가락질하다, 가리키다::指差すゆびさす
가로지르다, 횡단하다::横切るよこぎる
보내오다, 넘겨주다::寄越すよこす
부르다, 호소하다::呼びかけるよびかける
호출하다, 불러내다::呼び出すよびだす
소리 내어 읽다::読み上げるよみあげる
끝까지 다 읽다::読み切るよみきる
끝까지 다 읽다::読み通すよみとおす
읽고 이해하다::読み取るよみとる
어디까지나, 끝까지::あくまで
결국, 어쨌든, 조만간::いずれ
어느 쪽이든::いずれにせよ
당장에라도, 조금 있으면::今にもいまにも
도처에, 가는 곳마다::至るところいたるところ
일일이, 하나하나::いちいち
한층, 더욱, 훨씬::一段といちだんと
언제라도::いつでも
언제까지나, 영원히::いつまでも
어렴풋이, 희미하게::うっすら
우왕좌왕, 허둥지둥::うろうろ
매우, 썩, 많이::うんと
자칫, 자칫하면::得てしてえてして
대단히, 크게, 매우::大いにおおいに
대개, 대강, 대체로::おおむね
대강, 대략, 대체로::おおよそ
불쌍하게도::お気の毒におきのどくに
먼저::お先におさきに
늦어도::遅くともおそくとも
엉겁결에, 나도 모르게::思わずおもわず
받은 즉시, 곧바로::折り返しおりかえし
도리어, 오히려, 반대로::かえって
와르르, 드르륵::がらがら
만일, 만약, 임시로::仮にかりに
적어도, 그래도, 결코::仮にもかりにも
가뿐히, 거뜬히::軽々かるがる
시끄럽게 잔소리함, 띵함::がんがん
들쭉날쭉::ぎざぎざ
꼭,분명, 반드시::きっと
두리번두리번::きょろきょろ
반짝반짝::きらきら
빙글빙글, 둘둘::ぐるぐる
부쩍부쩍, 쑥쑥::ぐんぐん
실제로, 지금::現にげんい
극히, 대단히::極ごく
가만히, 살짝, 몰래::こっそり
대굴대굴, 오동통::ころころ
역시, 정말이지::さすが
졸졸, 보슬보슬::さらさら
게다가, 더욱더::更にさらに
아주 조용함, 고요함::しいんと
내내, 늘, 항상::始終しじゅう
따라서, 그러므로::従ってしたがって
단단히, 제대로, 야무지게::しっかり
촉촉히, 차분히::しっとり
절실히, 곰곰히::しみじみ
차례차례, 차례로::順々にじゅんじゅんに
척척, 술술, 거침없이::すいすい
쑥쑥, 무럭무럭::すくすく
불쑥, 쓱, 후련함, 개운함::すっと
이미, 벌써::既にすでに
술술, 척척, 거침없이::すらすら
죽, 줄줄이::ずらり
열심히, 부지런히::せっせと
꼭, 무슨 일이 있어도::是非ともぜひとも
그래서, 그런데::そこで
살짝, 몰래::そっと・そうっと
뒤이어, 잇달아::それからそれと
그런데도, 그래도::それでも
슬슬::そろそろ
매우, 아주, 대단히::大層たいそう
태반, 대부분::大半たいはん
상당히, 어지간히, 꽤::大分だいぶ・だいぶん
늘, 끊임없이::絶えずたえず
단호히, 단연코::断固だんこ
차츰, 점차, 서서히::段段だんだん
단지, 다만, 그저::単にたんに
머지않아, 일간::近近ちかぢか
때때로, 가끔::ちょいちょい
조금, 약간::ちょいと
뒤이어, 잇따라서::次いでついで
드디어, 마침내, 결국::ついに
곰곰이, 뚫어지게, 절실히::つくづく
매끈매끈, 반들반들::つるつる（と）
전전, 여기저기 옮겨 다님::転転てんてん
도무지, 도저히, 아무래도::どうも
여기저기::所所ところどころ
하여간, 어쨌든, 여하튼::ともかく
어쨌든, 여하튼::何しろなにしろ
아무쪼록, 부디::何分なにぶん
어떻게든, 간신히, 그럭저럭::何とかなんとか
왠지, 어쩐지::何となくなんとなく
정말, 뭐라고도::何ともなんとも
무슨, 어떤, 아무::何のなんの
남김 없이, 전부, 모두::残らずのこらず
느릿느릿, 꾸물꾸물::のろのろ
시원시원, 또랑또랑::はきはき
과연, 역시, 대체::果たしてはたして
싹둑, 싹::ばっさり
딱 마주침, 뚝 끊김::ばったり
대강, 얼추, 대충::一通りひととおり
우선, 일단::ひとまず
저절로, 자연히::ひとりでに
널찍한 모양::広々ひろびろ
중얼중얼, 투덜투덜::ぶつぶつ
문득, 갑자기::ふと
포동포동::ぶよぶよ
푹신푹신, 두둥실::ふわふわ
물씬, 뾰로통::ぷんぷん
폭신하게, 사뿐히::ふんわり（と）
흐릿함, 희미함, 멍함::ぼうっと
따끈따끈::ほかほか
슬슬, 조금씩::ぼつぼつ
부슬부슬::ぼろぼろ
참으로, 정말로::誠にまことに
우물쭈물::まごまご
설마, 정말이지::まさか
바로, 틀림없이, 정말로::まさに
차라리, 오히려::むしろ
뚜렷이, 현저히, 부쩍::めっきり
거의, 좀처럼::めったに
어쩌면::もしかしたら
만약에, 어쩌면::もしかして
만약, 만일의 경우::もしも
꾸물꾸물, 머뭇머뭇::もじもじ
본디부터, 원래::元元もともと
이미, 벌써, 어느새::もはや
머지않아, 이윽고::やがて
마구,몹시, 함부로::やたらに
흔들흔들, 하늘하늘::ゆらゆら
요컨대, 결국::要するにようするに
한층 더, 보다 더::より一層よりいっそう
기꺼이, 기쁘게::喜んでよろこんで
울렁울렁, 두근두근::わくわく
이어서, 연달아::相次いであいついで
짝, 한패::相棒あいぼう
파트너, 상대::パートナー
밝다, 정통하다::明るいあかるい
포기, 단념::諦めあきらめ
절망::絶望ぜつぼう
비다, 짬이 나다::空くあく
끝나다::済むすむ
다음날, 익일::あくる日あくるひ
목표, 기대, 가망::当てあて
전망, 예상, 목표::見込みみこみ
잘못, 실수::過ちあやまち
과실::過失かしつ
걸음, 발걸음::歩みあゆみ
보행::歩行ほこう
걷다::歩むあゆむ
걷다::歩くあるく
사전에::事前にじぜんに
다툼::争いあらそい
변명::弁解べんかい
쉬운, 적당한::イージーな
손쉬운, 안이한, 적당한::安易なあんいな
예를 들면::例えてみればたとえてみれば
잘::うまく
순조롭게::順調にじゅんちょうに
왕왕, 이따금::往々にしておうおうにして
때때로, 가끔::時々ときどき
대폭적으로::大幅におおはばに
현격히::格段にかくだんに
내세우다, 부각하다::押し出すおしだす
한층 강하게 내세우다::一段と強く打ち出すいちだんとつよくうちだす
과감히::思い切っておもいきって
단호히::断然だんぜん
무심코::思わずおもわず
무의식적으로::無意識にむいしきに
비용, 경비::掛かりかかり
지출::出費しゅっぴ
머리가 좋다::頭がいいあたまがいい
일찍이, 예전에는::かつては
이전에는::以前にいぜんに
기프트, 선물::ギフト
선물::贈り物おくりもの
균형::均衡きんこう
개개, 각기, 각기::個個ここ
각각, 각기::おのおの・それぞれ
마음이 든든하다::気丈夫だきじょうぶだ
요령::こつ
요령::要領ようりょう
컨테이너, 화물용 상자::コンテナ
용기::入れ物いれもの
차이::差異さい
다름, 차이::違いちがい
사엽::事業じぎょう
구조::仕組みしくみ
서포트, 지지::サポート
시선::視線しせん
눈길, 시선, 눈빛::まなざし
시나리오, 각본::シナリオ
각본::脚本きゃくほん
꽤, 상당히::かなり
스케치, 사생::スケッチ
사생::写生しゃせい
모두,전부::すべて
남김없이::残らずのこらず
비유,예::例えたとえ
비유::比喩ひゆ
쉽다, 용이하다::たやすい
쉽다::やさしい
결국::結局けっきょく
타결하다, 매듭 짓다::手を打つてをうつ
계약하다::契約するけいやくする
결국은::結局はけっきょくは
트러블, 분쟁, 고장::トラブル
분규, 분쟁::もめごと
고장::故障こしょう
괴롭히다::悩ますなやます
괴롭히다::苦しめるくるしめる
즉각, 당장::にわかに
바로::すぐに
빛나다, 돋보이다::映えるはえる
돋보이다, 두드러지다::引き立つひきたつ
퍼레이드, 행진::パレード
행렬::行列ぎょうれつ
판명되다::判明するはんめいする
확인되다::確認されるかくにんされる
상당히, 매우::非常にひじょうに
아주, 굉장히::とても
부착하다::付着するふちゃくする
붙다, 달라붙다::くっつく
문득::ふと
아무 생각 없이::何の気なしになんのきなしに
녹초가 됨::へとへと
나른함, 흐물흐물해짐::くたくた
포인트, 요점::ポイント
요점::要点ようてん
곧::もうすぐ
목록::目録もくろく
병, 나쁜 버릇::病やまい
병, 질병, 나쁜 버릇::病気びょうき
여유::余裕よゆう
요컨대::要するにようするに
즉, 요컨대, 결국::つまり
랭킹, 순위::ランキング
순위::順位じゅんい
램프, 전등::ランプ
전등::電灯でんとう
레이스, 경주::レース
경주::競争きょうそう
레슨, 수업, 연습::レッスン
배움, 익힘, 연습::稽古けいこ
간신히, 겨우::わずかに
간신히, 겨우::かろうじて・やっと
아케이드, 상점가::アーケード
아트, 예술, 미술::アート
아이스크림::アイスクリーム
아이템, 항목, 품목::アイテム
아이보리, 상아빛::アイボリー
아이론, 다리미::アイロン
아웃, 밖, 실격::アウト
엑세스, 접근, 교통편::アクセス
악센트, 억양, 강조::アクセント
액티브, 활동적임, 적극적임::アクティブ
업, 상승, 인상::アップ
어프로치, 접근::アプローチ
알파벳::アルファベット
안테나::アンテナ
언밸런스, 불균형함::アンバランス
이지, 간편함, 손쉬움::イージー
이퀄, 같음, 등호::イコール
이벤트, 행사::イベント
이미지, 인상::イメージ
인스톨, 설치::インストール
인터뷰, 면접::インタビュー
임팩트, 충돌, 충격::インパクト
위스키::ウイスキー
우먼, 여성, 여자::ウーマン
울, 양털, 모직물::ウール
웨이트리스, 여자 종업원::ウエートレス
에어메일, 항공 우편::エアメール
에티켓, 예의범절::エチケット
에이프런, 앞치마::エプロン
엔지니어, 기술자::エンジニア
오리지널, 원작, 독창적인::オリジナル
오르간::オルガン
온라인::オンライン
커브, 곡선, 굽음::カーブ
가이드북, 안내서::ガイドブック
껌::ガム
컬러, 색, 색깔::カラー
캡틴, 주장::キャプテン
캠퍼스, 대학::キャンパス
글라스, 유리컵, 안경::グラス
클럽::クラブ
클리어, 꺠끗함, 통과함::クリア
클리닝, 세탁, 청소::クリーニング
크리스마스::クリスマス
그룹, 집단::グループ
크레딧카드, 신용카드::クレジットカード
케어, 주의, 조심, 돌봄, 보살핌::ケア
게스트, 손님::ゲスト
코스, 진로, 방향::コース
코치, 지도자::コーチ
코드, 부호, 암호, 규정::コード
골, 목표, 목표를 달성함::ゴール
요리사, 조리사::コック
카피, 복사, 사본::コピー
고무::ゴム
코멘트, 논평, 의견::コメント
칼럼::コラム
컬렉션, 수집품::コレクション
콘크리트::コンクリート
콘센트::コンセント
컨트롤, 통제, 조절::コントロール
콤플렉스::コンプレックス
서클, 동아리, 동호회::サークル
서비스::サービス
사이렌, 경적::サイレン
사인, 서명::サイン
시트::シート
진, 청바지::ジーンズ
제트기::ジェット
시그널, 신호::シグナル
시스템, 제도, 체계::システム
저널리스트, 언론인::ジャーナリスト
셔터::シャッター
숍, 상점, 가게::ショップ
시리즈::シリーズ
심플, 검소함, 단순함::シンプル
스카프::スカーフ
스태프, 담당자, 제작진::スタッフ
스테미너, 체력, 끈기::スタミナ
스탠드, 관람석, 판매대::スタンド
스탬프, 우편물의 소인::スタンプ
스튜어디스, 여자 승무원::スチュワーデス
스테이지, 무대::ステージ
스테이션, 정거장, 역::ステーション
스텝, 걸음, 단계::ステップ
스타킹::ストッキング
스톱, 정지, 멈춤, 정류소::ストップ
스피커::スピーカ
스피드, 속도, 속력::スピード
스포츠카::スポーツカー
스마트, 말쑥함, 단정하고 멋짐::スマート
슬라이드, 미끄러짐::スライド
세트, 한 벌, 한 쌍::セット
시멘트::セメント
센터, 중앙 기관::センター
타이머, 스톱워치::タイマー
타임, 시각, 시간::タイム
다이어그램, 운행표, 도표::ダイヤグラム
다이아몬드::ダイヤモンド
다이얼::ダイヤル
댐::ダム
데미지, 피해, 손해::ダメージ
타워, 탑::タワー
차지, 충전, 요금::チャージ
초크, 분필::チョーク
치라시, 광고용 전단지::チラシ
테마, 주제::テーマ
데모, 시위::デモ
텐트, 천막::テント
트럭, 화물차::トラック
드라마::ドラマ
트럼프, 카드::トランプ
트레이닝, 훈련, 연습::トレーニング
드레스::ドレス
터널, 굴::トンネル
나일론::ナイロン
넘버, 번호::ナンバー
니즈, 필요, 수요, 요구::ニーズ
노르마, 할당량::ノルマ
바이올린::バイオリン
파이프, 관::パイプ
파일럿, 비행 조종사::パイロット
바케스, 양동이, 들통::バケツ
패스포트, 여권::パスポート
패터, 유형::パターン
퍼블릭, 공공적임, 대중적임::パブリック
핸섬, 미남임::ハンサム
팬츠, 바지::パンツ
핸드백::ハンドバッグ
핸들, 손잡이::ハンドル
피크, 정상, 정점::ピーク
권총::ピストル
비타민::ビタミン
비닐::ビニール
빌딩::ビルディング（＝ビル）
핀::ピン
프라이팬::フライパン
프라이빗, 사적임::プライベート
블라우스::ブラウス
브러시, 솔::ブラシ
플라스틱::プラスチック
프리, 자유로움, 무료::フリー
프레시, 신선함, 참신함::フレッシュ
프로, 전문적::プロ
플로어, 층, 마룻바닥::フロア
브로치::ブローチ
프로그램, 예정표::プログラム
프로젝트, 계획::プロジェクト
프런트, 접수대::フロント
페이스, 속도, 보조::ペース
베스트, 최선, 최고::ベスト
베테랑, 노련한 사람::ベテラン
헬리콥터, 헬기::ヘリコプター
벨트, 혁대, 띠::ベルト
페인트::ペンキ
벤치, 긴 의자::ベンチ
펜치::ペンチ
보너스, 상여금::ボーナス
마켓, 시장, 판로::マーケット
마이크::マイク
마이너스, 손해::マイナス
마스크, 가면, 탈::マスク
마스터, 숙달함::マスター
머플러, 목도리::マフラー
마라톤::マラソン
맨션, 중, 고층 아파트::マンション
미팅,모임::ミーティング
재봉틀::ミシン
미스, 실패, 실수::ミス
멤버, 구성원::メンバー
모터, 전동기::モーター
모던, 현대적임::モダン
모델, 원형, 견본::モデル
모노레일::モノレール
유럽::ヨーロッパ
요트::ヨット
라이터::ライター
라이벌, 경쟁 상대::ライバル
라이브, 생방송, 실황::ライブ
라이프스타일, 생활 방식::ライフスタイル
라인,선, 줄::ライン
라운지, 휴게실::ラウンジ
라운드, 둥긂, 일주, 순환::ラウンド
라켓::ラケット
러닝, 달리기, 러닝셔츠::ランニング
리얼, 현실적임, 사실적임::リアル
리듬::リズム
리본::リボン
루즈, 느슨함, 야무지지 않음::ルーズ
레인코트, 우비::レインコート
레크리에이션, 오락, 휴양::レクリエーション
렌즈::レンズ
로켓::ロケット
로커, 사물함, 보관함::ロッカー
로비, 휴게실::ロビー
와인, 포도주::ワイン
어리다, 미숙하다, 유치하다::幼いおさない
틈, 짬, 사이::合間あいま
나쁜 버릇::悪癖あくへき
선명함, 또렷함::鮮やかあざやか
철거부지, 잔해::跡地あとち
의심하다, 걱정하다::危ぶむあやぶむ
경쟁하다, 다투다::争うあらそう
새로움::新たあらた
유감::遺憾いかん
의의::意義いぎ
분노::憤りいきどおり
떳떳하다, 미련 없이 깨끗하다::潔いいさぎよい
유적::遺跡いせき
여전히::依然としていぜんとして
이르다::至るいたる
일률적으로, 무조건::一概にいちがいに
거짓::偽りいつわり
부정할 수 없다::否めないいなめない
경고하다, 제지하다::戒めるいましめる
호소하다, 소송하다::訴えるうったえる
재촉하다, 촉구하다::促すうながす
축축해지다, 혜택을 받다::潤ううるおう
축이다, 적시다, 윤택하게 하다::潤すうるおす
영양::栄養えいよう
원활함::円滑えんかつ
연주::演奏えんそう
응모::応募おうぼ
대폭적임, 큰 폭::大幅おおはば
언덕, 작은 산::丘おか
과자::お菓子おかし
게을리하다, 방심하다::怠るおこたる
아까워하다, 애석해하다::惜しむおしむ
덮치다, 습격하다::襲うおそう
온화함, 조용하고 한가로움::穏やかおだやか
방문하다::訪ねるたずねる
쇠약해지다::衰えるおとろえる
위협하다::脅かすおびやかす
표면화함::表向きおもてむき
어리석은::愚かなおろかな
개혁::改革かいかく
조개껍데기::貝殻かいがら
해협::海峡かいきょう
회고::回顧かいこ
간호, 간병::介護かいご
괴수::怪獣かいじゅう
해소::解消かいしょう
개선::改善かいぜん
개척::開拓かいたく
개략, 대략::概略がいりゃく
돌이켜보다, 반성하다::省みるかえりみる
빛나다::輝くかがやく
울타리::垣根かきね
획일적::画一的かくいつてき
격차::格差かくさ
각종::各種かくしゅ
화재::火災かさい
치우치다::偏るかたよる
화단::花壇かだん
겸하다::兼ねるかねる
얽히다::絡むからむ
간섭::干渉かんしょう
감독::監督かんとく
완화::緩和かんわ
기업::企業きぎょう
희곡::戯曲ぎきょく
기혼자::既婚者きこんしゃ
쌓다::築くきずく
위조::偽造ぎぞう
엄하다, 심하다::厳しいきびしい
의무::義務ぎむ
각본, 대본::脚本きゃくほん
구원::救援きゅうえん
구릉, 언덕::丘陵きゅうりょう
응축::凝縮ぎょうしゅく
경탄::驚嘆きょうたん
공명, 공진, 동감함, 공감함::共鳴きょうめい
거부::拒否きょひ
긴박함::緊迫きんぱく
음미, 잘 조사하여 고름::吟味ぎんみ
화초::草花くさばな
무너뜨리다::崩すくずす
무너지다::崩れるくずれる
부서지다, 깨지다::砕けるくだける
썩어 없어지다::朽ち果てるくちはてる
뒤엎다::覆すくつがえす
나눠 주다, 분배하다::配るくばる
상세하다, 자세하다::詳しいくわしい
군집::群集ぐんしゅう
경위::経緯けいい
경사지다::傾斜するけいしゃする
경솔함::軽率けいそつ
결함::欠陥けっかん
결핍::欠乏けつぼう
낌새, 기운::気配けはい
혐오감::嫌悪感けんおかん
엄정함::厳正げんせい
현저하게::顕著にけんちょに
검토::検討けんとう
현명함::賢明けんめい
행위::行為こうい
호쾌함::豪快ごうかい
공헌::貢献こうけん
향신료::香辛料こうしんりょう
흥분::興奮こうふん
교묘한::巧妙なこうみょうな
행락지::行楽地こうらくち
고령화::高齢化こうれいか
고갈::枯渇こかつ
극복::克服こくふく
마음을 씀, 걱정함, 배려::心遣いこころづかい
기분 좋다, 상쾌하다::快いこころよい
고장::故障こしょう
잔돈::小銭こぜに
담다, 포함하다::込めるこめる
지향하다, 지망하다::志すこころざす
거부하다::拒むこばむ
고용::雇用こよう
식단, 메뉴::献立こんだて
근저, 밑바탕, 기초::根底こんてい
혼란::混乱こんらん
채택::採択さいたく
채무::債務さいむ
막다, 차단하다::遮るさえぎる
찢다::裂くさく
삭감::削減さくげん
탐색하다, 더듬어 찾다::探るさぐる
피하다, 비키다, 꺼리다::避けるさける
지탱하다::支えるささえる
지시, 지휘::指図さしず
착각::錯覚さっかく
살균::殺菌さっきん
쓸쓸하다::寂しいさびしい
색채, 특색, 경향::色彩しきさい
자기::自己じこ
자숙::自粛じしゅく
자세::姿勢しせい
시설::施設しせつ
사태::事態じたい
그리워하다, 연모하다, 우러르다::慕うしたう
존경받다::慕われるしたわれる
실비::実費じっぴ
집필::執筆しっぴつ
연극, 연기::芝居しばい
경사면::斜面しゃめん
수익::収益しゅうえき
시종, 줄곧, 내내::終始しゅうし
중시::重視じゅうし
충실함::充実じゅうじつ
집착::執着しゅうちゃく
유연함::柔軟じゅうなん
종래::従来じゅうらい
축하 모임::祝賀会しゅくがかい
취지::趣旨しゅし
축소::縮小しゅくしょう
수상::首相しゅしょう
수목::樹木じゅもく
수요::需要じゅよう
증상::症状しょうじょう
승낙::承諾しょうだく
양보::譲歩じょうほ
장려::奨励しょうれい
처벌::処罰しょばつ
시력::視力しりょく
신경::神経しんけい
신앙::信仰しんこう
진흥::振興しんこう
심사::審査しんさ
인재::人材じんざい
진주::真珠しんじゅ
신속함::迅速じんそく
신중함::慎重しんちょう
인맥::人脈じんみゃく
수시::随時ずいじ
추진::推進すいしん
숭배::崇拝すうはい
튼튼함, 건전함::健やかすこやか
권하다::勧めるすすめる
스러지다, 유행하지 않게 되다::廃れるすたれる
재빠름, 신속함::速やかすみやか
맑다, 맑아지다::澄むすむ
성대함::盛大せいだい
정부 소식통::政府筋せいふすじ
설치::設置せっち
절충::折衷せっちゅう
전도, 앞길::前途ぜんと
상호::相互そうご
시세::相場そうば
첨부하다, 곁들이다::添えるそえる
속박::束縛そくばく
파손하다, 상하게 하다::損なうそこなう
소재::素材そざい
저지::阻止そし
소송::訴訟そしょう
조치, 조처::措置そち
솔선::率先そっせん
서로, 다 함께::互いにたがいに
타협::妥協だきょう
대비해 두다, 저장하다::蓄えるたくわえる
떠돌다, 감돌다, 표류하다::漂うただよう
벗어나다, 탈출하다, 이탈하다::脱するだっする
치유::治癒ちゆ
중순::中旬ちゅうじゅん
중추::中枢ちゅうすう
조각::彫刻ちょうこく
징수::徴収ちょうしゅう
침묵::沈黙ちんもく
진열::陳列ちんれつ
소비하다::費やすついやす
다하다, 애쓰다::尽くすつくす
보상, 속죄::償いつぐない
고하다, 알리다::告げるつげる
모집하다, 더해지다::募るつのる
관철하다::貫くつらぬく
제안::提案ていあん
저택::邸宅ていたく
간편하게, 손쉽게::手軽にてがるに
솜씨, 수완::手際てぎわ
철저, 투철::徹底てってい
철야::徹夜てつや
전환::転換てんかん
전형::典型てんけい
전통적::伝統的でんとうてき
첨부::添付てんぷ
도기, 도자기::陶器とうき
답습하다, 전철을 밟다::踏襲するとうしゅうする
소중하다, 귀중하다::尊いとうとい
독촉::督促とくそく
정체되다, 막히다::滞るとどこおる
외치다, 주장하다::唱えるとなえる
이웃, 옆::隣となり
부족하다, 가난하다::乏しいとぼしい
도매상::問屋とんや
모종::苗なえ
바라보다::眺めるながめる
달래다, 위로하다::慰めるなぐさめる
탄식하다::嘆くなげく
여운, 흔적::名残なごり
모방하다, 따르다::倣うならう
밤낮, 언제나, 늘::日夜にちや
둔해지다::鈍るにぶる
인내::忍耐にんたい
꿰매다::縫うぬう
끈덕지게 버티다::粘るねばる
노리다::狙うねらう
임하다::臨むのぞむ
파악::把握はあく
폐기물::廃棄物はいきぶつ
빛나다, 훌륭하고 돋보이다::映えるはえる
막연함::漠然ばくぜん
폭로::暴露ばくろ
힘쓰다, 노력하다::努めるつとめる
끝, 가장자리::端はし
파손::破損はそん
화분, 사발::鉢はち
발굴::発掘はっくつ
화려함::華やかはなやか
바닷가::浜辺はまべ
범죄::犯罪はんざい
반사::反射はんしゃ
번식::繁殖はんしょく
만능::万能ばんのう
피해자::被害者ひがいしゃ
비참함::悲惨ひさん
사람의 그림자, 인적::人影ひとかげ
인품::人柄ひとがら
인질::人質ひとじち
미묘함::微妙びみょう
평판::評判ひょうばん
피로, 공표함::披露ひろう
빈부::貧富ひんぷ
보급::普及ふきゅう
모욕::侮辱ぶじょく
재차, 다시::再びふたたび
부담::負担ふたん
부흥::復興ふっこう
부임::赴任ふにん
부패::腐敗ふはい
불평등::不平等ふびょうどう
발 디딜 곳::踏み場ふみば
폐쇄::閉鎖へいさ
별장::別荘べっそう
변천::変遷へんせん
봉사::奉仕ほうし
방대함::膨大ぼうだい
풍부함::豊富ほうふ
포화::飽和ほうわ
자랑하다::誇るほこる
묘지::墓地ぼち
본고장::本場ほんば
조달하다, 마련하다::賄うまかなう
헷갈리기 쉽다::紛らわしいまぎらわしい
길모퉁이::街角まちかど
닦다, 아름답게 하다, 갈고닦다, 갈다::磨くみがく
스스로::自らみずから
근원, 수원::源みなもと
무언, 말이 없음::無言むごん
무조건::無条件むじょうけん
미신::迷信めいしん
명예::名誉めいよ
돌다, 둘러싸다::巡るめぐる
망라::網羅もうら
맹렬함::猛烈もうれつ
모색::模索もさく
세상사, 매사::物事ものごと
모양, 무늬::模様もよう
누그러지다::和らぐやわらぐ
유서::由緒ゆいしょ
유망함::有望ゆうぼう
땅거미, 황혼::夕闇ゆうやみ
유령::幽霊ゆうれい
용이함::容易ようい
양상::様相ようそう
치장하다, 가장하다::装うよそおう
승낙, 납득, 양해::了承りょうしょう
이력::履歴りれき
윤리적::倫理的りんりてき
유사, 비슷함::類似るいじ
연일, 매일::連日れんじつ
복도::廊下ろうか
노쇠::老衰ろうすい
틀, 테두리::枠わく
테두리 안::枠内わくない
궁리, 고안::工夫くふう
열람::閲覧えつらん
변명, 해명::釈明しゃくめい
조짐, 징조::兆しきざし
합병::合併がっぺい
이익::利益りえき
근거::根拠こんきょ
본 줄거리, 본론::本筋ほんすじ
반주::伴奏ばんそう
추리::推理すいり
허술한, 불충분한::手薄なてうすな
부수다, 고장내다::壊すこわす
번성, 번창::繁盛はんじょう
계약::契約けいやく
붙임성::愛想あいそ、あいそう
애착::愛着あいちゃく
감히, 굳이, 억지로, 무리하게::あえて
밝히다, 털어놓다::明(か)すあかす
악랄하다, 악착같다::あくどい
한계점에 이름::頭打ちあたまうち
어이없다, 싱겁다::あっけない
산뜻한 모양, 간단히, 깨끗이::あっさり
압도::圧倒あっとう
압박::圧迫あっぱく
의심스럽다::危ぶまれるあやぶまれる
불확실함, 모호함::あやふや
실수하다, 잘못하다::誤るあやまる
미리, 사전에::予めあらかじめ
고치다, 개선하다::改めるあらためる
사실대로::ありのままに
살리다::生かすいかす
어떻게든, 아무리 생각해도, 정말, 매우::いかにも
이색적임, 색다름::異色いしょく
만지작거리다::いじる
일임::一任いちにん
일면, 온통::一面いちめん
일련, 일행::一連いちれん
일환::一環いっかん
일거에, 단숨에::一挙にいっきょに
우수한 인재::逸材いつざい
도리어, 차라리::いっそ
일소하다::一掃するいっそうする
일탈하다, 벗어나다::逸脱するいつだつする
의도::意図いと
매우, 아주::いとも
불쾌하다, 징그럽다::いやらしい
의욕::意欲いよく
바이러스::ウイルス
웨이트, 무게, 중점::ウエイト（＝ウエート）
받아들이다::受け入れるうけいれる
받다::受けるうける
근질근질하다, 좀이 쑤시다::うずうずしている
깜빡, 무심코, 멍청히::うっかり
솜씨, 역량::腕前うでまえ
빠르게 올라감::うなぎのぼり
자만하다::うぬぼれる
운용::運用うんよう
열람실::閲覧室えつらんしつ
엘레강트, 우아함::エレガント
원만함::円満えんまん
짊어지다, 혜택을 입다::負うおう
응급::応急おうきゅう
왕성::旺盛おうせい
대강, 대략, 요점::大筋おおすじ
초과, 오버::オーバー
거의, 대강, 아마, 필시::大方おおかた
과장됨, 야단스러움::大げさおおげさ
대범함, 대충, 세세한 점에까지 구애받지 않는 모양::おおまか
대범하고 느긋함::おおらか
잠잠해지다::おさまる
쭈뼛쭈뼛::おどおど
풍취, 멋::趣おもむき
어리석음::愚かおろか
소홀히 함, 등한함::おろそか
회수::回収かいしゅう
해제::解除かいじょ
회심, 마음에 듦::会心かいしん
개설, 내용을 개략적으로 설명함::概説がいせつ
해당::該当がいとう
개입::介入かいにゅう
개념::概念がいねん
간호, 병구완::介抱かいほう
발이 넓다::顔が広いかおがひろい
확실함::確実かくじつ
혁신::革新かくしん
확보::確保かくほ
서둘러 가다, 급히 달려가다::駆けつけるかけつける
가결되다::可決されるかけつされる
가감, 조절::加減かげん
가공::加工かこう
부피가 커지다::かさむ
옆, 곁::かたわら
획기적임::画期的かっきてき
가동::稼働かどう
개러지, 차고::ガレージ
과로::過労かろう
겨우, 간신히::かろうじて
완결::完結かんけつ
완고함::頑固がんこ
커닝::カンニング
위해::危害きがい
걱정, 마음에 걸림::気掛かりきがかり
규격::規格きかく
어렵게 여김, 스스럼::きがね
껄끄러움, 어색함::ぎくしゃく
기권::棄権きけん
삐걱거리다::きしむ
규제::規制きせい
정확하게, 깔끔하게, 꼭 맞는 모양::きっちり
딱 잘라, 단호하게::きっぱり（と）
비위에 거슬리다::気に障るきにさわる
규범::規範きはん
기반::基盤きばん
기품::気品きひん
기복::起伏きふく
각하, 기각::却下きゃっか
커리어, 경력::キャリア
휴양::休養きゅうよう
기여::寄与きよ
기용::起用きよう
교훈::教訓きょうくん
강경함::強硬きょうこう
즐기다, 흥겨워하다::興じるきょうじる
강제::強制きょうせい
긴급::緊急きんきゅう
금물::禁物きんもつ
구사하다::駆使するくしする
입이 무겁다::口がかたい
클레임, 불만::クレーム
형세::形勢けいせい
경력::経歴けいれき
결속::結束けっそく
혹평하다, 헐뜯다::けなす
냅다, 맵고 싸하다::煙たいけむたい
권위::権威けんい
언급::言及げんきゅう
견실함::堅実けんじつ
건전함::健全けんぜん
엄밀함::厳密げんみつ
합의::合議ごうぎ
항의::抗議こうぎ
교섭::交渉こうしょう
향상::向上こうじょう
고려::考慮こうりょ
소양, 이해::心得こころえ
마음에 새기다, 유의하다::心がけるこころがける
마음 든든하다::心強いこころづよい
뒤틀리다, 복잡해지다::こじれる
구애되다::こだわる
과장::誇張こちょう
요령::こつ
모조리, 죄다, 남김없이, 전부 ::ことごとく
어쩌면::ことによると
자상함, 세밀함::こまやか
치밀어 오르다::こみあげる
커뮤니케이션::コミュニケーション
고립::孤立こりつ
이렇다 할::これといった
데굴데굴::ごろごろ（と）
컨스탄트, 꾸준히::コンスタントに
재고::在庫ざいこ
사이즈::サイズ
재발::再発さいはつ
지장이 있다::差し支えるさしつかえる
가망이 없어 포기하다::さじをなげる
헤아리다, 살피다, 미루어 알다::察するさっする
자못, 아주, 정말로::さも
참조::参照さんしょう
완성하다::仕上げるしあげる
무리하여, 억지로, 굳이, 구태여::強いてしいて
셰어, 점유율::シェア
자각::自覚じかく
시기::時期じき
짜임새, 얼개, 구조, 시스템::仕組み（＝メカニズム）しくみ
지장::支障ししょう
사퇴::辞退じたい
시크, 멋진 모양, 세련된 모양::シック
실정::実情じつじょう
고집이 세다::しぶとい
스며들다, 배다::染みるしみる
시야::視野しや
차단::遮断しゃだん
장르::ジャンル
종사::従事じゅうじ
수복, 복원::修復しゅうふく
숙지::熟知じゅくち
주장::主張しゅちょう
주도권::主導権しゅどうけん
정보망::（情報）網じょうほうもう
처치::処置しょち
진정, 드림::進呈しんてい
추이::推移すいい
상쾌하다, 시원하다, 산뜻하다::すがすがしい
몹시 격렬하다, 무섭다, 무시무시하다, 굉장하다::すさまじい
스타일::スタイル
묵직한::ずっしりと
스톡, 재고::ストック
민첩하다::すばしこい
스페이스, 공간::スペース
날씬하게, 척척, 순조롭게::すんなり
제한::制限せいげん
정력적임::精力的せいりょくてき
성급하게, 침착하지 못하게::せかせかと
절실함::切実せつじつ
섭취::摂取せっしゅ
절대적인::絶大なぜつだいな
애달프다::せつない
설립::設立せつりつ
세레모니, 의식::セレモニー
선고, 전형::選考せんこう
센서::センサー
센스::センス
장대함::壮大そうだい
갖추어지다::備わるそなわる
무정하다, 냉담하다::そっけない
안절부절 못함::そわそわ
거칢, 일을 소홀히 함, 아무렇게나 함::ぞんざい
존속::存続そんぞく
대처::対処たいしょ
대담함::大胆だいたん
엉망이 됨::台無しだいなし
타개::打開だかい
다각적::多角的たかくてき
늠름하다::たくましい
타진, 떠봄, 알아봄::打診だしん
칭찬하다, 기리다::たたえる
대신 갚아주다::立て替えるたてかえる
길을 따라가다::たどる
헐렁헐렁::だぶだぶ
주저하다::ためらう
나른하다::だるい
단언::断言だんげん
단축::短縮たんしゅく
충고::忠告ちゅうこく
직면::直面ちょくめん
직감적으로::直感的にちょっかんてきに
데이터::データ
때늦음, 시기를 놓침::手遅れておくれ
적응::適応てきおう
일을 척척 해내는 모양::てきぱきと
디자인::デザイン
디저트, 후식::デザート
순서, 절차::手順てじゅん
철거::撤去てっきょ
틀림없이, 꼭::てっきり
동의::同意どうい
동감::同感どうかん
통합::統合とうごう
도저히::到底とうてい
그럭저럭, 겨우::どうにか
특기::特技とくぎ
돌파::突破とっぱ
시치미를 떼다::とぼける
단속::取り締まりとりしまり
단속하다::取り締まるとりしまる
되찾다, 회복하다::取り戻すとりもどす
유난히, 특히::とりわけ
긴 안목으로 보다::長い目で見るながいめでみる
달래다, 관대한 조치를 하다::なだめる
아무렇지도 않다::なにげない
부디, 아무쪼록::何とぞなにとぞ
시류에 편승하다::波に乗るなみにのる
지나치게 친한 척하다::なれなれしい
넌센스::ナンセンス
번지다, 스미다, 드러나다::にじむ
짊어지다::担うになう
뉘앙스, 미묘한 차이::ニュアンス
인식::認識にんしき
찰기, 끈기::粘りねばり
염원::念願ねんがん
염두::念頭ねんとう
노하우::ノウハウ
집집마다, 일제히, 다 함께::軒並のきなみ
바람직하다::のぞましい
한가로움, 날씨가 화창함::長閑のどか
노르마, 기준량, 할당량::ノルマ
배경::背景はいけい
배려::配慮はいりょ
허들, 기준, 장애물::ハードル
몹시 어리석다::ばかばかしい
파기::破棄はき
튀기다, 튕겨 내다::はじく
들뜨다, 신이 나다::弾むはずむ
발췌::抜粋ばっすい
코를 찌르다::鼻をつくはなをつく
폭넓다::幅広いはばひろい
조마조마::はらはら
반응::反応はんのう
사무치게, 뼈저리게, 절실히::ひしひしと
한숨 돌림::一息ひといき
나들이 인파::人出ひとで
표명::表明ひょうめい
빈약함::貧弱ひんじゃく
빈번함::頻繁ひんぱん
파이팅, 투지::ファイト
풍습::風習ふうしゅう
폼, 모양::フォーム
폴로, 지원::フォロー
깊어지다::深まるふかまる
어울리다, 걸맞다, 상응하다, 적합하다::ふさわしい
무난함::無難ぶなん
충분히 갖추어지지 않음::不備ふび
휘청휘청, 비틀비틀::ふらふら
어슬렁어슬렁, 빈둥빈둥::ぶらぶら
출발점, 처음 상태::振り出しふりだし
부록::付録ふろく
병행::並行へいこう
편의::便宜べんぎ
반납, 반환::返却へんきゃく
보답하다, 알리다::報じるほうじる
보충::補充ほじゅう
모집::募集ぼしゅう
몰수::没収ぼっしゅう
발족::発足ほっそく
베풀다, 주다, 행하다, 장식하다::施すほどこす
흐려지다, 희미해지다::ぼやける
본심, 속마음::本音ほんね
뿌리다::まく
교차하다, 뒤섞이다::交わるまじわる
제각각, 각기 다름::まちまち
면하다, 피하다::免れるまぬがれる
언뜻 보다::見かけるみかける
전망, 예정::見込みみこみ
밀접함::密接みっせつ
착실히, 충실히, 열심히, 흠씬::みっちり
옷차림::身なりみなり
신변::身の回りみのまわり
미련::未練みれん
무드, 분위기::ムード
무계획::無計画むけいかく
무효::無効むこう
몹시, 공연히, 무턱대고::無性にむしょうに
터무니 없음, 당치 않음::無茶むちゃ
공허하다, 허무하다::むなしい
무모함::無謀むぼう
명백함::明白めいはく
명랑함::明朗めいろう
눈에 띄게, 두드러지게::めきめき
눈앞, 현재, 당장::目先めさき
눈부시다::めざましい
미디어, 매체::メディア
목표 전망::めど
돌봐 주다::面倒を見るめんどうをみる
면밀함::綿密めんみつ
모형::模型もけい
목하, 현재::目下もっか
오로지, 한결같이::もっぱら
대접하다, 환대하다::もてなす
애가 타다, 안타깝다::もどかしい
약하다, 여리다::もろい
정면으로, 직접::もろに
야심::野心やしん
까다롭다::ややこしい
부드럽게, 살며시::やんわり
유망함::有望ゆうぼう
유머::ユーモア
유혹::誘惑ゆうわく
엇갈림, 오해, 착오::行き違いゆきちがい、いきちがい
여유::ゆとり
흔들리다::揺らぐゆらぐ
늦추다, 느슨하게 하다::ゆるめる
억제::抑制よくせい
양성::養成ようせい
예단, 예측::予断よだん
여파::余波よは
되살아나다::よみがえる
낙관적::楽観的らっかんてき
리드::リード
리스크, 위험::リスク
리스트업, 나열, 열거::リストアップ
이성적::理性的りせいてき
유출::流出りゅうしゅつ
영역::領域りょういき
유추::類推るいすい
루즈, 단정치 못함, 허술함::ルーズ
레이아웃::レイアウト
레벨, 수준::レベル
낭비::浪費ろうひ
제대로, 변변히::ろくに
로맨틱함, 낭만적임::ロマンチック
논리::論理ろんり
새람스러이, 일부러, 특별히::わざわざ
귀찮다, 성가시다, 뒤얽혀 복잡하다::わずらわしい
끼어들다::割り込むわりこむ
궤적::軌跡きせき
모순::矛盾むじゅん
쾌거::快挙かいきょ
조장::助長じょちょう
결성::結成けっせい
풀리다, 누그러지다, 온화해지다::解れるほぐれる
척도, 기준, 표준, 치수::尺度しゃくど
관습, 관례::しきたり
해약::解約かいやく
특산::特産とくさん
캐어묻다, 추궁하다::問い詰めるといつめる
개수, 수리::改修かいしゅう
극진하다, 융숭하다::手厚いてあつい
데마, 악선전, 유언::デマ
사전에, 미리::事前にじぜんに
평범한::平凡なへいぼんな
흔해빠진::有り触れたありふれた
안도했다::安堵したあんどした
안심했다, 한숨 돌렸다::ほっとした
아니나다를까::案の定あんのじょう
의욕::意欲いよく
지극히, 대단히::いたって
실마리, 단서::糸口いとぐち
불쾌감을 주는 말이나 행동::嫌味いやみ
어렴풋이::うすうす
열심히 몰두하고 있다::熱心に取り組んでいるねっしんにとりくんでいる
열중하다::熱中するねっちゅうする
흐지부지::うやむやに
뒷받침::裏付けうらづけ
증거::証拠しょうこ
당황하지 않고::うろたえずに
당황하지 않고, 허둥대지 않고::慌てずにあわてずに
액스퍼트, 전문가::エキスパート
고상한::上品なじょうひんな
전문가::専門家せんもんか
대체적인 취지, 대체로, 대강::おおむね
마음이 내키지 않고 귀찮은 모양::おっくう
속수무책이다::お手上げだおてあげだ
자연스레, 저절로::自ずとおのずと
무서워서::おびえて
사죄했다::お詫びしたおわびした
무서워서, 두려워서::怖がってこわがって
회상하다::回想するかいそうする
현격히::格段にかくだんに
완고한::かたくなな
과묵한::寡黙なかもくな
말수가 적은::口数が少ないくちかずがすくない
간소한::簡素なかんそな
응시했다::凝視したぎょうしした
지그시 봤다::じっと見たじっとみた
최대한, 힘껏::極力きょくりょく
편안히 쉬다, 마음을 터놓다::くつろぐ
편안히 하다::ゆっくりする
비방의 말을 듣다::けなされる
나쁜 말을 듣다::悪く言われるわるくいわれる
고의로::故意にこいに
일부러::わざと
대체적으로 같다::大体同じだだいたいおなじだ
자세하고 주의 깊게::詳しくて丁寧にくわしくてていねいに
소형의::小型のこがたの
사소한::ささいな
착각하다::勘違いするかんちがいする
쇄도했다::殺到したさっとうした
잡답, 붐빔, 혼잡::雑踏ざっとう
자주, 몇 번씩이나::しきりに
망치다::しくじる
실패하다::失敗するしっぱいする
자존심::自尊心じそんしん
프라이드, 자존심::プライド
시비어, 엄격하다::シビアだ
출마하다::出馬するしゅつばする
조회하다::照会するしょうかいする
문의하다::問い合わせるといあわせる
촉발되다, 자극받다::触発されるしょくはつされる
조언::助言じょげん
상쾌한::さわやかな
방법이 없다::すべがない
얇게 잘라서::薄く切ってうすくきって
서두르게 하다, 다그치다, 재촉하다::せかす
극찬하다::絶賛するぜっさんする
상대편::先方せんぽう
단적으로::端的にたんてきに
차분히, 곰곰이, 꼼꼼히::じっくりと
쓸모가 있어 편리하다::重宝しているちょうほうしている
잠깐 동안, 순간::つかの間つかのま
자세히, 구체적으로::つぶさに
상세하게::詳細にしょうさいに
중얼거리다, 투덜대다::つぶやく
수단, 방법, 방도::手立ててだて
철회하다::撤回したてっかいした
일을 분담함::手分けてわけ
당황해서, 어리둥절해서::とまどって
당분간 없다::当面ないとうめんない
친숙해지다::なじむ
난점, 곤란한 점::難点なんてん
끈기 있게::粘り強くねばりづよく
순조롭게 진행되고 있다::はかどっている
지원::支援しえん
발군, 뛰어났다::抜群だったばつぐんだった
지쳐 버렸다::ばててしまった
경쟁하다::張り合うはりあう
살짝, 몰래::ひそかに
살짝, 슬그머니, 남몰래::こっそり
불의로, 갑자기::ふいに
시끄러워졌다::紛糾したふんきゅうした
변명하고::弁解してべんかいして
방해하다::妨害するぼうがいする
포부::抱負ほうふ
투덜거리고 있다::ぼやいている
완수하다, 다하다::まっとうする
드문드문하다::まばらだ
맥락::脈絡みゃくらく
무상으로::無償でむしょうで
화가 났다, 불끈했다::むっとした
각각에게::めいめいに
이례적인::異例のいれいの
계획하다::もくろむ
어쩔 수 없이::やむを得ずやむをえず
여유::余裕よゆう
낙담하다::落胆するらくたんする
칠칠치 못하다::だらしない
낭보, 기쁜 소식::朗報ろうほう
날씨가 잔뜩 흐리다::どんよりした天気だ
흐려서 어둡다::曇っていて暗いくもっていてくらい
꼭 들어 맞추다, 적용시키다::当てはめるあてはめる
고집::固執こしつ
일률::一律いちりつ
일괄, 한데 묶음::一括いっかつ
언뜻 보기에::一見いっけん
이제와서::今更いまさら
이상하게, 묘하게::いやに
내역, 명세::内訳うちわけ
고개를 숙이다::うなだれる
압수::押収おうしゅう
한턱내다::おごる
골똘히 생각하다::思い詰めるおもいつめる
해명, 밝힘::解明かいめい
완고함, 막무가내임::かたくな
합치, 일치::合致がっち
희망대로 되다, 이루어지다::かなう
가령, 임시로::仮にかりに
환원::還元かんげん
조용함, 고요함::閑静かんせい
간소::簡素かんそ
완벽함::かんぺき
불쾌함, 아니꼬움::きざ
규제::規制きせい
기조, 바탕::基調きちょう
궤도::軌道きどう
극단적임::極端きょくたん
거점::拠点きょてん
균등하게::均等にきんとうに
긴밀함::緊密きんみつ
금물::禁物きんもつ
어긋나다, 엇갈리다::食い違うくいちがう
말참견::口出しくちだし
분명히, 뚜렷하게, 빠짐없이::くまなく
변통, 주머니 사정::工面くめん
경위::経緯けいい
결여::欠如けつじょ
교착, 이리 저리 뒤섞임::交錯こうさく
고상함::高尚こうしょう
광대함::広大こうだい
교부::交付こうふ
교묘함::巧妙こうみょう
짐작 가는 곳::心当たりこころあたり
마음가짐, 각오::心構えこころがまえ
세심함::細心さいしん
작동::作動さどう
매달리다::しがみつく
실각하다::失脚するしっきゃくする
검소함::質素しっそ
탄력이 있고 유연함::しなやか
사임::辞任じにん
종일::終日しゅうじつ
중복::重複じゅうふく
조합, 대조, 서로 맞추어 보고 확인함::照合しょうごう
승진::昇進しょうしん
친선::親善しんぜん
쇼크, 충격::ショック
늘어선 모양, 주욱::ずらっと
절멸, 멸종::絶滅ぜつめつ
상응, 어울림::相応そうおう
솜씨가 좋음::巧みたくみ
쉽다, 용이하다::たやすい
단일::単一たんいつ
조달::調達ちょうたつ
제기::提起ていき
통합::統合とうごう
어쩐지, 아무래도::どうやら
갈다::とぐ
이루다, 해내다, 성취시키다::遂げるとげる
훨씬 전에, 벌써::とっくに
순간적으로::とっさに
따르다::なつく
어떻게든, 그럭저럭::なんとか
활기차다, 붐비다::にぎわう
입수, 손에 넣음::入手にゅうしゅ
욕을 퍼붓다, 매도하다::ののしる
배포::配布はいふ
벗기다, 떼다::はがす
발산::発散はっさん
화가 나다::腹が立つはらがたつ
외곬으로, 한결같이::ひたむき
두 배, 갑절, 한층 더::人一倍ひといちばい
일손::人手ひとで
일단, 하여튼::ひとまず
품종::品種ひんしゅ
헐렁헐렁::ぶかぶか
불순::不順ふじゅん
복구::復旧ふっきゅう
불복, 불만, 납득이 가지 않음::不服ふふく
블랭크, 여백, 공백 기간::ブランク
굽실굽실::ぺこぺこ
자기를 낮추다::へりくだる
보이콧, 불매 동맹::ボイコット
몰두::没頭ぼっとう
슬슬, 조금씩::ぼつぼつ
흐뭇하다::ほほえましい
멸망하다, 쇠퇴하다::滅びるほろびる
섞다, 교차시키다, 주고받다::交えるまじえる
맨 먼저::真っ先まっさき
전부, 완전히::まるまる
만끽::満喫まんきつ
보던 것을 놓치다::見失うみうしなう
간과하다, 빠뜨리고 보다::見落とすみおとす
밀집::密集みっしゅう
목표, 기준::目安めやす
면식, 안면::面識めんしき
면제::免除めんじょ
이제는, 벌써::もはや
유수, 손꼽힘::有数ゆうすう
요망, 간절히 바람::要望ようぼう
훨씬, 상당히::よほど
리타이어, 기권, 은퇴::リタイア
양립, 병행::両立りょうりつ
제휴::連携れんけい
노골적임::露骨ろこつ
때::垢あか
턱::顎あご
삼, 삼베::麻あさ
목표, 기대, 전망::当てあて
그물, 망::網あみ
잘못, 실수::過ちあやまち
뜻, 마음::意い
꼭대기, 정상::頂いただき
소용돌이::渦うず
의심, 혐의::疑いうたがい
그릇, 용기::器うつわ
습기, 보탬, 혜택::潤いうるおい
자루, 손잡이::柄え
꼬리::尾お
공, 공공, 공정함::公おおやけ
동물의 수컷::雄おす
두려움::恐れおそれ
을::乙おつ
핵::核かく
사냥::狩りかり
관, 관리, 관직::官かん
암::癌がん
고삐, 정, 인연, 유대::絆きずな
줄기::茎くき
관, 대롱::管くだ
곳간, 창고::蔵くら
더러움::汚れけがれ、よごれ
짐승::獣けもの
갑::甲こう
달력::暦こよみ
술잔::杯さかずき
울타리::柵さく
모양, 상태, 모습::様さま
무사::侍さむらい
조수, 밀물, 썰물, 바닷물::潮しお
축, 굴대::軸じく
종, 종류, 종자::種しゅ
말, 사물의 끝::末すえ
밥상, 음식상::膳ぜん
상, 모습::相そう
승려::僧そう
부대::隊たい
키, 기장, 길이::丈たけ
방패::盾たて
영혼, 정신::魂たましい
공중, 하늘::宙ちゅう
창자::腸ちょう
쌍::対つい
통, 속이 비고 긴 관::筒つつ
뿔::角つの
이슬::露つゆ
동, 집의 수를 세는 말::棟とう
몸통, 몸의 중앙부::胴どう
정, 인정::情けなさけ
납::鉛なまり
보통, 중간::並なみ
흥청거림, 번화함::賑わいにぎわい
오줌, 소변::尿にょう
주인, 가장::主ぬし
늪::沼ぬま
소리::音ね
연, 총계::延のべ
저주::呪いのろい
폐::肺はい
깃발::旗はた
벌::罰ばつ
끝, 말로::果てはて
호숫가, 바닷가::浜はま
반, 조::班はん
도장::判はん
비, 비석, 비문::碑ひ
표, 명찰, 쪽지::票ひょう
봉함::封ふう
마디, 관절::節ふし
표찰, 표::札ふだ
이삭::穂ほ
개똥벌레, 반디::蛍ほたる
눈썹::眉まゆ
나무의 줄기::幹みき
봉우리::峰みね
맥, 맥박::脈みゃく
사위::婿むこ
떼, 무리::群れむれ
동물의 암컷::雌めす
상, 상중::喪も
화살::矢や
어둠::闇やみ
활::弓ゆみ
세상::世よ
욕심::欲よく
애교::愛嬌あいきょう
애석, 아쉬워함::愛惜あいせき
합석, 동석::合席あいせき
관계, 사이::間柄あいだがら
나쁜 짓, 악행::悪事あくじ
악화::悪化あっか
알선, 주선::斡旋あっせん
유화::油絵あぶらえ
암살::暗殺あんさつ
암산::暗算あんざん
암시::暗示あんじ
암묵::暗黙あんもく
집안, 가문::家柄いえがら
가출::家出いえで
육성::育成いくせい
이견::異見いけん
위엄::威厳いげん
의향::意向いこう
이주::移住いじゅう
위축::萎縮いしゅく
의상::衣装いしょう
의존::依存いそん、いぞん
위탁::委託いたく
한동안, 한때, 잠시::一時いちじ
외곬, 한결같음::一途いちず
일말, 아주 약간::一抹いちまつ
일약::一躍いちやく
똑같음, 한결같음::一様いちよう
한 번의 호흡, 단숨::一気いっき
일거, 한 번의 행동::一挙いっきょ
일색::一色いっしょく
일제, 동시::一斉いっせい
일소, 한꺼번에 없앰::一掃いっそう
일대::一帯いったい
일품, 걸작품::逸品いっぴん
일변, 완전히 달라짐::一変いっぺん
일화::逸話いつわ
번개::稲光いなびかり
위력::威力いりょく
의류::衣類いるい
위화감::違和感いわかん
인감::印鑑いんかん
은거::隠居いんきょ
인후, 목, 목구멍::咽喉いんこう
인솔::引率いんそつ
은폐::隠蔽いんぺい
음모::陰謀いんぼう
유무::有無うむ
바람기::浮気うわき
운영::運営うんえい
운운::云々うんぬん
운반::運搬うんぱん
운수::運輸うんゆ
위성::衛星えいせい
위생::衛生えいせい
예지, 뛰어난 지혜::英知えいち
영웅::英雄えいゆう
웃는 얼굴::笑顔えがお
역병, 돌림병::疫病えきびょう
가볍게 인사함::会釈えしゃく
터득::会得えとく
어획물, 사냥감::獲物えもの
툇마루, 지느러미살::縁側えんがわ
연안::沿岸えんがん
연극::演劇えんげき
원정::遠征えんせい
혼담::縁談えんだん
횡행, 활개침, 난무함::横行おうこう
황금::黄金おうごん
왕진::往診おうしん
큰 입, 큰소리, 거액::大口おおぐち
큰 손해::大損おおぞん
독직, 공직자의 비리::汚職おしょく
오욕, 수치::汚辱おじょく
은혜::恩恵おんけい
온난::温暖おんだん
온당하고 원만함, 모나지 않음::穏便おんびん
해운::海運かいうん
외화::外貨がいか
외관::外観がいかん
계급::階級かいきゅう
개간::開墾かいこん
회유::懐柔かいじゅう
계층::階層かいそう
개탄::慨嘆がいたん
개축::改築かいちく
바다 속::海中かいちゅう
회중, 주머니 속::懐中かいちゅう
회충::回虫かいちゅう
해충::害虫がいちゅう
가두, 길거리::街頭がいとう
외박::外泊がいはく
해발::海抜かいばつ
개방::開放かいほう
해부::解剖かいぼう
개막::開幕かいまく
전무, 전혀 없음::皆無かいむ
개요::概要がいよう
외래::外来がいらい
회람::回覧かいらん
해류::海流かいりゅう
학예::学芸がくげい
격차::格差かくさ
확산::拡散かくさん
격주::隔週かくしゅう
확신::確信かくしん
각성::覚醒かくせい
학설::学説がくせつ
획득::獲得かくとく
악보::楽譜がくふ
각별함::格別かくべつ
혁명::革命かくめい
격리::隔離かくり
확률::確率かくりつ
확립::確立かくりつ
가계, 생계::家計かけい
하천::河川かせん
화학섬유::化繊かせん
과제::課題かだい
한마디의 말, 서투른 말씨::片言かたこと
가축::家畜かちく
할애::割愛かつあい
갈채::喝采かっさい
합창::合唱がっしょう
합주::合奏がっそう
주가::株価かぶか
주식::株式かぶしき
화폐::貨幣かへい
안과::眼科がんか
안구, 눈알::眼球がんきゅう
감격::感激かんげき
간행::刊行かんこう
관행::慣行かんこう
권고::勧告かんこく
환산::換算かんさん
감시::監視かんし
관중::観衆かんしゅう
완숙, 완전히 익음::完熟かんじゅく
환성::歓声かんせい
관세::関税かんぜい
암석::岩石がんせき
감염::感染かんせん
관측::観測かんそく
관점::観点かんてん
감도::感度かんど
의절::勘当かんどう
원년::元年がんねん
완비::完備かんび
간부::幹部かんぶ
감명::感銘かんめい
관람::観覧かんらん
관료::官僚かんりょう
관례::慣例かんれい
환갑::還暦かんれき
기개::気概きがい
기획::企画きかく
기각::棄却ききゃく
귀경::帰京ききょう
기금::基金ききん
희극::喜劇きげき
의결::議決ぎけつ
기원::起源きげん
본래의 성질이나 생각::気心きごころ
기질, 성향::気質きしつ
천성, 기질::気性きしょう
위증::偽証ぎしょう
귀성::帰省きせい
기성::既成きせい
희생::犠牲ぎせい
기적::奇跡きせき
궤적::軌跡きせき
기증::寄贈きぞう、きそう
귀족::貴族きぞく
의제::議題ぎだい
흡연::喫煙きつえん
규정::規定きてい
기점::起点きてん
위독, 중태::危篤きとく
기백::気迫きはく
기풍::気風きふう
기말::期末きまつ
규약::規約きやく
각색::脚色きゃくしょく
역접::逆接ぎゃくせつ
역전::逆転ぎゃくてん
역류::逆流ぎゃくりゅう
객관::客観きゃっかん
역경::逆境ぎゃっきょう
궁극::究極きゅうきょく
구근, 알뿌리::球根きゅうこん
급사, 사환::給仕きゅうじ
흡수::吸収きゅうしゅう
휴전::休戦きゅうせん
궁전::宮殿きゅうでん
구습에서 오는 폐단, 생각이 고루함::旧弊きゅうへい
궁핍::窮乏きゅうぼう
급선무, 급한 일::急務きゅうむ
구명, 규명::究明きゅうめい
경이::驚異きょうい
위협::脅威きょうい
교과::教科きょうか
협회::協会きょうかい
공감::共感きょうかん
협의::協議きょうぎ
공급::供給きょうきゅう
경우, 처지, 형편::境遇きょうぐう
강행::強行きょうこう
흉작::凶作きょうさく
업자::業者ぎょうしゃ
향수, 누림::享受きょうじゅ
업종::業種ぎょうしゅ
교습::教習きょうしゅう
공술, 진술::供述きょうじゅつ
교직::教職きょうしょく
강제::強制きょうせい
행정::行政ぎょうせい
공존::共存きょうそん、きょうぞん
협조::協調きょうちょう
협정::協定きょうてい
향토::郷土きょうど
협박::脅迫きょうはく
업무::業務ぎょうむ
공여, 제공::供与きょうよ
향리, 고향::郷里きょうり
국한::局限きょくげん
극한::極限きょくげん
국면, 형세::局面きょくめん
거행::挙行きょこう
거식, 결혼식을 올림::挙式きょしき
거주::居住きょじゅう
거절::拒絶きょぜつ
어선::漁船ぎょせん
어촌::漁村ぎょそん
허용::許容きょよう
큰 이익::巨利きょり
의리::義理ぎり
근교::近郊きんこう
근소한 차이::僅差きんさ
근년, 근래::近年きんねん
우연::偶然ぐうぜん
굴절::屈折くっせつ
군함::軍艦ぐんかん
경호::警護けいご
형성::形成けいせい
형태::形態けいたい
형벌::刑罰けいばつ
기류::気流きりゅう
근골::筋骨きんこつ
공허::空虚くうきょ
구제::救済きゅうさい
어둠, 어두운 곳::暗闇くらやみ
군축, 군비 축소::軍縮ぐんしゅく
경감::軽減けいげん
경시::軽視けいし
경장, 간편한 옷차림::軽装けいそう
계발::啓発けいはつ
의혹::疑惑ぎわく
근로::勤労きんろう
격감, 급감::激減げきげん
격노::激怒げきど
혈관::血管けっかん
결행::決行けっこう
결승::決勝けっしょう
결백::潔白けっぱく
결말::結末けつまつ
가신, 하인, 부하::家来けらい
검거::検挙けんきょ
권한::権限けんげん
결의::決意けつい
결합::結合けつごう
월부::月賦げっぷ
결근::欠勤けっきん
격추::撃墜げきつい
결핵::結核けっかく
꾀병::仮病けびょう
험악::険悪けんあく
엄금::厳禁げんきん
건재::健在けんざい
건승::健勝けんしょう
원천::源泉げんせん
감퇴::減退げんたい
건투::健闘けんとう
검약, 절약::倹約けんやく
권력::権力けんりょく
교역::交易こうえき
항구, 영구::恒久こうきゅう
호황, 호경기::好況こうきょう
공작, 만듦::工作こうさく
공제::控除こうじょ
행진::行進こうしん
공공연함::公然こうぜん
구속::拘束こうそく
호화저택::豪邸ごうてい
구독::購読こうどく
공모::公募こうぼ
효율::効率こうりつ
원작::原作げんさく
엄수::厳守げんしゅ
원소::元素げんそ
감속::減速げんそく
견지::見地けんち
원점::原点げんてん
원폭, 원자폭탄::原爆げんばく
원유::原油げんゆ
언론::言論げんろん
항해::航海こうかい
소리를 높여서 욺, 통곡::号泣ごうきゅう
광업::鉱業こうぎょう
고원::高原こうげん
강습::講習こうしゅう
공세::攻勢こうせい
구상::構想こうそう
후퇴::後退こうたい
구두, 입으로 말함::口頭こうとう
황폐::荒廃こうはい
항복::降伏こうふく
오만함, 거만함::傲慢ごうまん
검찰::検察けんさつ
엄선::厳選げんせん
환상::幻想げんそう
원칙::原則げんそく
감점::減点げんてん
원문::原文げんぶん
겸용::兼用けんよう
후회::後悔こうかい
경작::耕作こうさく
구술::口述こうじゅつ
갱신::更新こうしん
항쟁::抗争こうそう
광택::光沢こうたく
강독::講読こうどく
구매::購買こうばい
행락::行楽こうらく
호위::護衛ごえい
합성::合成ごうせい
호각, 막상막하::互角ごかく
고소::告訴こくそ
국방::国防こくぼう
국제연합, 유엔::国連こくれん
고아::孤児こじ
골자, 요점::骨子こっし
고분::古墳こふん
근간::根幹こんかん
근원::根源こんげん
곤충::昆虫こんちゅう
근본::根本こんぽん
재해::災害さいがい
세월::歳月さいげつ
재원::財源ざいげん
채취::採取さいしゅ
재정::財政ざいせい
최면::催眠さいみん
작전::作戦さくせん
산산이 부서짐, 산산조각::粉々こなごな
세공::細工さいく
고객::顧客こきゃく
고지, 알림, 통지::告知こくち
국유, 국가 소유::国有こくゆう
기분, 마음::心地ここち
사정, 일, 사물의 형편, 사정::事柄ことがら
소폭::小幅こはば
혼잡::混雑こんざつ
혼미::混迷こんめい
재기, 기지::再起さいき
채굴::採掘さいくつ
재건::再建さいけん
채집::採集さいしゅう
재적, 재학::在籍ざいせき
최량, 최선, 가장 좋음::最良さいりょう
사기::詐欺さぎ
책략::策略さくりゃく
비법, 극의, 무술의 가장 심오한 경지::極意ごくい
혹평::酷評こくひょう
극락::極楽ごくらく
오차::誤差ごさ
과시::誇示こじ
호적::戸籍こせき
고독::孤独こどく
바둑판::碁盤ごばん
고래, 예로부터::古来こらい
혼혈::混血こんけつ
혼동::混同こんどう
세균::細菌さいきん
채결::採決さいけつ
재직::在職ざいしょく
세포::細胞さいぼう
재량::裁量さいりょう
착오::錯誤さくご
좌절::挫折ざせつ
재현::再現さいげん
잡화::雑貨ざっか
쇄도, 밀려옴::殺到さっとう
산화::酸化さんか
산출::産出さんしゅつ
산맥::山脈さんみゃく
치과::歯科しか
사고, 생각::思考しこう
자산::資産しさん
불기운이 약해짐, 한고비 지남::下火したび
질환::疾患しっかん
실황::実況じっきょう
실권::実権じっけん
실질::実質じっしつ
실태::実態じったい
지적::指摘してき
자부::自負じふ
지방::脂肪しぼう
지문::指紋しもん
사살::射殺しゃさつ
약간, 어느 정도::若干じゃっかん
차량::車両しゃりょう
주기::周期しゅうき
수작, 걸작::秀作しゅうさく
종식::終息しゅうそく
수록::収録しゅうろく
숙련::熟練じゅくれん
주최::主催しゅさい
주창::主唱しゅしょう
출범::出帆しゅっぱん
수여::授与じゅよ
수립::樹立じゅりつ
소거::消去しょうきょ
작금, 요즘::昨今さっこん
쇄신::刷新さっしん
좌표::座標ざひょう
잔금::残金ざんきん
선창, 부두::桟橋さんばし
사육::飼育しいく
자아::自我じが
자금::資金しきん
지향::志向しこう
지극, 더없음, 극히::至極しごく
시차::時差じさ
자수::自首じしゅ
선생, 스승::師匠ししょう
실가, 생가, 친정::実家じっか
질의::質疑しつぎ
실형::実刑じっけい
집행::執行しっこう
질책::叱責しっせき
책자::冊子さっし
살인::殺人さつじん
산악::山岳さんがく
참사::惨事さんじ
잔고, 잔액::残高ざんだか
산물::産物さんぶつ
자영::自営じえい
시행, 실시::施行しこう
지옥::地獄じごく
사색::思索しさく
사직::辞職じしょく
자식::子息しそく
바탕, 기초, 소질::下地したじ
실격::失格しっかく
실각::失脚しっきゃく
실언::失言しつげん
실재::実在じつざい
조화를 잃음::失調しっちょう
노포, 오래된 점포::老舗しにせ
사법::司法しほう
전말, 끝, 모양::始末しまつ
사교::社交しゃこう
축하::祝賀しゅくが
취업::就業しゅうぎょう
석사::修士しゅうし
수축::収縮しゅうしゅく
종속::従属じゅうぞく
숙명::宿命しゅくめい
수예::手芸しゅげい
종자::種子しゅし
수비::守備しゅび
순조로운 환경::順境じゅんきょう
증언::証言しょうげん
자기 배, 자기 돈::自腹じばら
지망::志望しぼう
사죄::謝罪しゃざい
사절::謝絶しゃぜつ
습격::襲撃しゅうげき
숙려, 숙고::熟慮じゅくりょ
주권::主権しゅけん
주축::主軸しゅじく
수법, 기교::手法しゅほう
생애, 평생::生涯しょうがい
소강, 조금 안정됨::小康しょうこう
자갈::砂利じゃり
숙녀::淑女しゅくじょ
설사::下痢げり
겸업::兼業けんぎょう
현행::現行げんこう
가지고 다님, 휴대::携行けいこう
계략::計略けいりゃく
상질, 질이 좋음::上質じょうしつ
소식::消息しょうそく
소멸::消滅しょうめつ
제외::除外じょがい
서행::徐行じょこう
촉각::触覚しょっかく
서평::書評しょひょう
풋내기, 아마추어::素人しろうと
침해::侵害しんがい
심경::心境しんきょう
진격::進撃しんげき
신흥::新興しんこう
친교::親交しんこう
진실::真実しんじつ
심정::心情しんじょう
신성::神聖しんせい
신비::神秘しんぴ
칭찬::賞賛しょうさん
성취::成就じょうじゅ
정진, 전념::精進しょうじん
상륙::上陸じょうりく
처분::処分しょぶん
서면::書面しょめん
쓰라린 고생::辛苦しんく
진공, 진격::進攻しんこう
진재, 지진으로 인한 재해::震災しんさい
동반 자살::心中しんじゅう
침식::浸食しんしょく
진전::進展しんてん
신약::新薬しんやく
침공::侵攻しんこう
소사, 타 죽음::焼死しょうし
상술, 자세하게 진술함::詳述しょうじゅつ
초조::焦燥しょうそう
증인::証人しょうにん
조명::照明しょうめい
증류::蒸留じょうりゅう
직무::職務しょくむ
소지::所持しょじ
서민::庶民しょみん
시류, 그 시대의 경향::時流じりゅう
지령::指令しれい
진화::進化しんか
심의::審議しんぎ
신혼::新婚しんこん
신전, 신사의 본전::神殿しんでん
신념::信念しんねん
진리::真理しんり
침략::侵略しんりゃく
맨발::素足すあし
추장, 권함::推奨すいしょう
출납::出納すいとう
맨손, 빈손::素手すで
정예::精鋭せいえい
정의::定義ていぎ
정적::静的せいてき
정돈::整頓せいとん
세무::税務ぜいむ
얼굴을 붉힘::赤面せきめん
절찬, 극찬::絶賛ぜっさん
섬유::繊維せんい
선교::宣教せんきょう
전수, 전공::専修せんしゅう
잠수::潜水せんすい
전제::前提ぜんてい
전투::戦闘せんとう
진료::診療しんりょう
쇠퇴::衰退すいたい
수포, 물거품::水泡すいほう
생육, 자라서 커짐::生育せいいく
서구::西欧せいおう
정국::政局せいきょく
제재::制裁せいさい
정복::征服せいふく
정렬::整列せいれつ
절반, 반분함::折半せっぱん
시비, 옳고 그름::是非ぜひ
전쾌, 완쾌::全快ぜんかい
선언::宣言せんげん
선서::宣誓せんせい
선도::先導せんどう
선박::船舶せんぱく
도처, 여기저기, 곳곳::随所ずいしょ
수전, 논::水田すいでん
정권::政権せいけん
제정::制定せいてい
정도, 정밀도::精度せいど
정밀::精密せいみつ
책무::責務せきむ
절판::絶版ぜっぱん
선회::旋回せんかい
선처::善処ぜんしょ
공중 목욕탕::銭湯せんとう
잠입::潜入せんにゅう
선망::羨望せんぼう
전멸::全滅ぜんめつ
점령::占領せんりょう
전례::前例ぜんれい
창간::創刊そうかん
증강::増強ぞうきょう
종합::総合そうごう
상실::喪失そうしつ
증진::増進ぞうしん
쟁탈::争奪そうだつ
증정::贈呈ぞうてい
장비::装備そうび
저해::阻害そがい
즉석::即席そくせき
저격::狙撃そげき
소생, 되살아남::蘇生そせい
퇴화::退化たいか
체현, 구현::体現たいげん
대망::待望たいぼう
선량::善良ぜんりょう
세련::洗練せんれん
창건::創建そうけん
수사::捜査そうさ
조종::操縦そうじゅう
창조::創造そうぞう
장착::装着そうちゃく
소동::騒動そうどう
쌍벽::双璧そうへき
즉사::即死そくし
소통::疎通そつう
존엄::尊厳そんげん
퇴각, 후퇴::退却たいきゃく
퇴치::退治たいじ
태세::態勢たいせい
체납::滞納たいのう
태만::怠慢たいまん
선율::旋律せんりつ
선례, 전례::先例せんれい
총회::総会そうかい
잡목::雑木ぞうき
수색::捜索そうさく
수신, 야윈 몸::痩身そうしん
조난::遭難そうなん
창립::創立そうりつ
촉진::促進そくしん
즉각, 곧::即刻そっこく
내구, 오래 견딤::耐久たいきゅう
대중::大衆たいしゅう
대세::大勢たいせい
대장, 장부::台帳だいちょう
대여::貸与たいよ
타격::打撃だげき
타결::妥結だけつ
탈출::脱出だっしゅつ
다발, 많이 발생함::多発たはつ
탄원::嘆願たんがん
단결::団結だんけつ
단절::断絶だんぜつ
단념::断念だんねん
단면::断面だんめん
담화::談話だんわ
축적::蓄積ちくせき
착실::着実ちゃくじつ
착목, 주목, 착안::着目ちゃくもく
추출::抽出ちゅうしゅつ
조인::調印ちょういん
청강::聴講ちょうこう
저서::著書ちょしょ
추구::追求ついきゅう
추락::墜落ついらく
꺼내 보임, 제시::呈示ていじ
졸작::駄作ださく
달인::達人たつじん
들것::担架たんか
탄환::弾丸だんがん
탐험::探検たんけん
탄소::炭素たんそ
단파::短波たんぱ
탄력::弾力だんりょく
지기, 지인::知己ちき
질서::秩序ちつじょ
착수::着手ちゃくしゅ
착공::着工ちゃっこう
청각::聴覚ちょうかく
저축::貯蓄ちょちく
침몰::沈没ちんぼつ
추적::追跡ついせき
통감::痛感つうかん
제시::提示ていじ
저조::低調ていちょう
탈세::脱税だつぜい
탐구::探求たんきゅう
탐지::探知たんち
담판::談判だんぱん
단련, 연마::鍛錬たんれん
축산::畜産ちくさん
질식::窒息ちっそく
착색::着色ちゃくしょく
중재::仲裁ちゅうさい
중화::中和ちゅうわ
징후, 조짐::兆候ちょうこう
조정, 중재::調停ちょうてい
저속::低速ていそく
임금::賃金ちんぎん
추방::追放ついほう
해일::津波つなみ
제창::提唱ていしょう
제방, 둑::堤防ていぼう
적당함::適当てきとう
적출, 집어냄, 들추어 냄::摘出てきしゅつ
수고, 귀찮음, 손::手数てすう
철강::鉄鋼てっこう
철퇴, 철수::撤退てったい
전설::伝説でんせつ
천벌::天罰てんばつ
전망::展望てんぼう
동거::同居どうきょ
통제::統制とうせい
도달::到達とうたつ
동조::同調どうちょう
동봉::同封どうふう
특집::特集とくしゅう
독단::独断どくだん
도상, 도중::途上とじょう
쏙 내민 끝::突端とったん
나리, 영주님::殿様とのさま
도래::渡来とらい
노예::奴隷どれい
적성::適性てきせい
철회::撤回てっかい
철수::撤収てっしゅう
철봉::鉄棒てつぼう
전달::伝達でんたつ
전복::転覆てんぷく
전래::伝来でんらい
토의::討議とうぎ
도자기 공예::陶芸とうげい
동향::動向どうこう
동지::同志どうし
동상::銅像どうぞう
통치::統治とうち
동등::同等どうとう
답변::答弁とうべん
담력, 배짱::度胸どきょう
독주::独奏どくそう
특파::特派とくは
특허::特許とっきょ
씨름판::土俵どひょう
소름::鳥肌とりはだ
적발::摘発てきはつ
수갑::手錠てじょう
철칙::鉄則てっそく
전가, 떠넘김::転嫁てんか
첨삭::添削てんさく
전임, 전근::転任てんにん
점포::店舗てんぽ
전락::転落てんらく
동기::動機どうき
투고::投稿とうこう
투자::投資とうし
동정::同情どうじょう
통솔::統率とうそつ
투입::投入とうにゅう
동요::動揺どうよう
득책, 상책::得策とくさく
익명::匿名とくめい
특권::特権とっけん
독, 제방::土手どて
거래::取引とりひき
나락, 밑바닥::奈落ならく
음색::音色ねいろ
열량::熱量ねつりょう
연감::年鑑ねんかん
연배, 나이 또래::年配ねんぱい
연륜::年輪ねんりん
배급::配給はいきゅう
삼가 빌려 씀::拝借はいしゃく
배제::排除はいじょ
패전::敗戦はいせん
배양::培養ばいよう
파괴::破壊はかい
폭격::爆撃ばくげき
박탈::剥奪はくだつ
파견::派遣はけん
발육::発育はついく
내란::内乱ないらん
눈사태::雪崩なだれ
임의::任意にんい
임신::妊娠にんしん
열의::熱意ねつい
점액::粘液ねんえき
염출, 각출::捻出ねんしゅつ
염불::念仏ねんぶつ
농경::農耕のうこう
배기::排気はいき
배출, 배설::排出はいしゅつ
배임::背任はいにん
배율::倍率ばいりつ
폐수::廃水はいすい
파급::波及はきゅう
박약, 빈약::薄弱はくじゃく
폭탄::爆弾ばくだん
파탄::破綻はたん
발아::発芽はつが
발현::発現はつげん
날고기, 생고기::生身なまみ
열탕, 뜨거운 물::熱湯ねっとう
연하, 신년 축하::年賀ねんが
연소::燃焼ねんしょう
연료::燃料ねんりょう
농축::濃縮のうしゅく
폐기::廃棄はいき
배후::背後はいご
배척::排斥はいせき
패배::敗北はいぼく
박해::迫害はくがい
자백::白状はくじょう
폭파::爆破ばくは
봉밀, 벌꿀, 꿀::蜂蜜はちみつ
발각::発覚はっかく
벌채::伐採ばっさい
발주::発注はっちゅう
번영::繁栄はんえい
반격::反撃はんげき
만반, 모든 사항이나 수단::万端ばんたん
만인::万人ばんにん
부결::否決ひけつ
비중::比重ひじゅう
비장::秘蔵ひぞう
필연::必然ひつぜん
한줄기, 외곬, 일편 단심::一筋ひとすじ
미모::美貌びぼう
비약::飛躍ひやく
병상, 병세::病状びょうじょう
비화::秘話ひわ
편승::便乗びんじょう
봉쇄::封鎖ふうさ
포교, 전도::布教ふきょう
복종::服従ふくじゅう
발열::発熱はつねつ
반감::反感はんかん
판결::判決はんけつ
만사::万事ばんじ
범주, 카테고리::範疇はんちゅう
만년, 노년::晩年ばんねん
반란::反乱はんらん
응달, 그늘::日陰ひかげ
비결::秘訣ひけつ
미소::微笑びしょう
비축::備蓄びちく
인파, 사람의 물결::人波ひとなみ
빈정거림, 비꼼, 야유::皮肉ひにく
비명::悲鳴ひめい
묘사::描写びょうしゃ
평판, 인기가 있음::評判ひょうばん
비료::肥料ひりょう
빈혈::貧血ひんけつ
빈도::頻度ひんど
풍속::風俗ふうぞく
복합::複合ふくごう
발병::発病はつびょう
파열::破裂はれつ
반향::反響はんきょう
판연, 명백함::判然はんぜん
판정::判定はんてい
비관::悲観ひかん
피상, 거죽, 표면::皮相ひそう
한때, 한동안, 왕년::一頃ひところ
남의 눈::人目ひとめ
불꽃, 불똥, 불티::火花ひばな
파면::罷免ひめん
표창::表彰ひょうしょう
비옥함::肥沃ひよく
미량, 극소량::微量びりょう
빈곤::貧困ひんこん
빈핍, 빈곤, 가난::貧乏びんぼう
불휴, 불멸::不朽ふきゅう
복면::覆面ふくめん
범람::氾濫はんらん
복리, 복지::福利ふくり
부채::負債ふさい
무장::武装ぶそう
부단함, 끊임없음::不断ふだん
물자::物資ぶっし
불상::仏像ぶつぞう
부양::扶養ふよう
분기, 분발::奮起ふんき
분쇄::粉砕ふんさい
분실::紛失ふんしつ
분쟁::紛争ふんそう
분투::奮闘ふんとう
분열::分裂ぶんれつ
평상, 평소, 보통::平常へいじょう
편견::偏見へんけん
변설, 언변::弁舌べんぜつ
변모::変貌へんぼう
보육::保育ほいく
방위::防衛ぼうえい
망외, 기대한 이상임::望外ぼうがい
봉건::封建ほうけん
부호, 갑부::富豪ふごう
부식::腐食ふしょく
불손, 무례::不遜ふそん
부활::復活ふっかつ
불식::払拭ふっしょく
물체::物体ぶったい
의의, 뜻밖::不慮ふりょ
분업::分業ぶんぎょう
분수, 주제::分際ぶんざい
분사::噴射ふんしゃ
분말::粉末ふんまつ
병기, 무기::兵器へいき
질림, 손듦, 질색, 항복함::閉口へいこう
폐막::閉幕へいまく
변혁::変革へんかく
변호::弁護べんご
병용::併用へいよう
방기, 포기::放棄ほうき
모험::冒険ぼうけん
부진::不振ふしん
물의::物議ぶつぎ
물색::物色ぶっしょく
비등, 끓어오름::沸騰ふっとう
부보, 부고::訃報ふほう
부력::浮力ふりょく
분개::憤慨ふんがい
격분::憤激ふんげき
분산::分散ぶんさん
분출::噴出ふんしゅつ
편지 왕래::文通ぶんつう
분리::分離ぶんり
폐업::閉業へいぎょう
미곡, 곡물::米穀べいこく
병렬, 줄을 지음::並列へいれつ
반환::返還へんかん
변상::弁償べんしょう
변동::変動へんどう
변론::弁論べんろん
법안::法案ほうあん
붕괴::崩壊ほうかい
방어::防御ぼうぎょ
방책::方策ほうさく
풍작::豊作ほうさく
방적::紡績ぼうせき
팽창::膨張ぼうちょう
방임::放任ほうにん
보온::保温ほおん
박멸::撲滅ぼくめつ
보장::保障ほしょう
발기, 갑자기 일어남::勃起ぼっき
발발::勃発ぼっぱつ
포로::捕虜ほりょ
본망, 숙원::本望ほんもう
매설::埋設まいせつ
마취::麻酔ますい
말초, 말끝::末梢まっしょう
만장::満場まんじょう
미각::味覚みかく
미연::未然みぜん
묘안::妙案みょうあん
방치::放置ほうち
법정::法廷ほうてい
폭동::暴動ぼうどう
포상::褒美ほうび
폭락::暴落ぼうらく
포경, 고래잡이::捕鯨ほげい
포획::捕獲ほかく
보강::補強ほきょう
보상::補償ほしょう
발흥, 진흥::勃興ぼっこう
몰락::没落ぼつらく
본능::本能ほんのう
번롱, 농락::翻弄ほんろう
진심, 정성::真心まごころ
말단::末端まったん
만성::慢性まんせい
신분, 신병::身柄みがら
민중::民衆みんしゅう
방출::放出ほうしゅつ
방청::傍聴ぼうちょう
모독::冒涜ぼうとく
폭력::暴力ぼうりょく
보관::保管ほかん
모금::募金ぼきん
발작::発作ほっさ
발단, 시초::発端ほったん
보양::保養ほよう
본말::本末ほんまつ
본론::本論ほんろん
매몰::埋没まいぼつ
바로 밑, 바로 아래::真下ました
말소::抹消まっしょう
마비::麻痺まひ
온몸, 전신, 집안::身内みうち
수분, 물기::水気みずけ
밀도::密度みつど
무연고, 관계가 없음::無縁むえん
무게, 중량::目方めかた
면역::免疫めんえき
귀찮음, 돌봄, 보살핌::面倒めんどう
망상::妄想もうそう
묵인::黙認もくにん
상복::喪服もふく
직무의 성질, 직책이 있는 신분::役柄やくがら
지방 공무원이 사무를 보는 곳::役場やくば
대지, 집의 부지, 저택::屋敷やしき
유괴::誘拐ゆうかい
융자::融資ゆうし
꿈길::夢路ゆめじ
용액::溶液ようえき
양식, 일정한 양식::様式ようしき
요약::要約ようやく
무단::無断むだん
명중::命中めいちゅう
눈길, 시선::目線めせん
면직::免職めんしょく
면목, 체면::面目めんもく
맹점::盲点もうてん
모방::模倣もほう
직무, 관리직::役職やくしょく
유언::遺言ゆいごん
유종, 끝을 잘 맺음::有終ゆうしゅう
웅변::雄弁ゆうべん
유연::悠然ゆうぜん
유발::誘発ゆうはつ
우려::憂慮ゆうりょ
여운::余韻よいん
요괴, 도깨비::妖怪ようかい
용서::容赦ようしゃ
요인::要因よういん
여가::余暇よか
무념::無念むねん
명부::名簿めいぼ
멸망::滅亡めつぼう
면책::免責めんせき
혹서, 심한 더위::猛暑もうしょ
목격::目撃もくげき
약진::躍進やくしん
역할::役割やくわり
우월::優越ゆうえつ
융합::融合ゆうごう
우세::優勢ゆうせい
유치, 불러들임::誘致ゆうち
우아하고 아름다움::優美ゆうび
유목::遊牧ゆうぼく
융화::融和ゆうわ
요인::要因よういん
양호::養護ようご
보양, 건축 파손 방지의 손질::養生ようじょう
요청::要請ようせい
서양풍, 서양식::洋風ようふう
예감::予感よかん
여흥::余興よきょう
억양::抑揚よくよう
예고::予告よこく
욕구::欲求よっきゅう
낙담::落胆らくたん
남용::濫用らんよう
유보, 보류::留保りゅうほ
입각::立脚りっきゃく
이윤::利潤りじゅん
양극::両極りょうきょく
영지::領地りょうち
이론::理論りろん
임종::臨終りんじゅう
냉장::冷蔵れいぞう
연결::連結れんけつ
연방::連邦れんぽう
당황함, 허둥지둥함::狼狽ろうばい
노무::労務ろうむ
노출::露出ろしゅつ
활 모양으로 굽음::湾曲わんきょく
억압::抑圧よくあつ
억류::抑留よくりゅう
여담::余談よだん
여론::輿論よろん
낙농::酪農らくのう
도리, 이치::理屈りくつ
이성::理性りせい
편리, 편의::利便りべん
양질::良質りょうしつ
영토::領土りょうど
윤곽::輪郭りんかく
윤리::倫理りんり
연행::連行れんこう
연맹::連盟れんめい
노력, 수고::労力ろうりょく
노점::露店ろてん
혹성::惑星わくせい
열거::列挙れっきょ
욕망::欲望よくぼう
예언::予言よげん
예조, 전조, 징조::予兆よちょう
약한 말, 나약한 말::弱音よわね
납치::拉致らち、らっち
이자::利子りし
이자::利息りそく
약탈::略奪りゃくだつ
영해::領海りょうかい
임업::林業りんぎょう
연계::連係れんけい
한 패, 동아리, 일당, 그 패들::連中れんちゅう
낭독::朗読ろうどく
좋은 소식::朗報ろうほう
녹화::録画ろくが
논의::論議ろんぎ
테두리 안, 범위 내::枠内わくない
용감::勇敢ゆうかん
시정, 자물쇠를 잠금::施錠せじょう
침하, 가라앉아 내려감::沈下ちんか
서로 물다, 서로 심하게 싸우다, 맞물리다, 토론이 순조롭게 진행되다::噛み合うかみあう
제멋대로 굶::気ままきまま
마음을 들뜨게 하다, 자아내다, 돋우다::そそる
풍류가 없다, 어색하다, 불편하다::ぎこちない
단연코, 반드시, 꼭, 기어이::断じてだんじて
쳐다보다, 우러러보다::仰ぐあおぐ
질리다::飽きるあきる
바래다::褪せるあせる
폭로하다, 파헤치다::暴くあばく
조종하다, 다루다::操るあやつる
사과하다::謝るあやまる
새로워지다, 격식을 차리다::改まるあらたまる
합치다::合わせるあわせる
다치다, 손상하다::痛めるいためる
영위하다, 경영하다::営むいとなむ
초조하게 하다, 애태우다::いらだてる
엷어지다::薄まるうすまる
심어지다::植えられるうえられる
늙다::老いるおいる
무릅쓰다::冒すおかす
고요해지다, 가라앉다::治まるおさまる
붉어지다, 불그레해지다::赤らむあからむ
응석부리다, 어리광부리다::甘えるあまえる
망치다, 휩쓸다::荒らすあらす
걱정하다, 염려하다::案じるあんじる
망가뜨리다, 상하게 하다::傷めるいためる
거절하다, 사절하다::否むいなむ
이어받다, 계승하다::受け継ぐうけつぐ
묻다, 매장하다::埋めるうめる
싫어하다, 멀리하다::疎んじるうとんじる
흥하다, 일어나다::興るおこる
장사하다::商うあきなう
조소하다, 비웃다::嘲笑うあざわらう
주문하다, 맞추다::あつらえる
저술하다::著すあらわす
불쌍히 여기다, 사랑하다::慈しむいつくしむ
받다, 받아들이다::受け止めるうけとめる
침범하다, 침해하다::侵すおかす
억제하다, 막다::抑えるおさえる
닦다, 수양하다::修めるおさめる
밀다, 추진시키다::推すおす
중요시하다::重んじるおもんじる
해치다, 상하게 하다::害するがいする
뒤돌아보다, 회상하다::顧みるかえりみる
걸다, 내기를 하다::かける
안개가 끼다, 희미하게 보이다::霞むかすむ
굳히다, 다지다::固めるかためる
들어맞추다, 충족시키다::適えるかなえる
갖추다, 자세를 취하다::構えるかまえる
주고받다, 교환하다::交わすかわす
잘 움직이다, 기능을 발휘하다::利くきく
기약하다::期するきする
다투다, 경쟁하다::競うきそう
금하다::禁じるきんじる
빠지다, 헤어나지 못하게 되다::陥るおちいる
향하여 가다, 즉시 향하다::赴くおもむく
내걸다::掲げるかかげる
빠지다, 걸여하다::欠くかく
스치다::擦れるすれる
얽매이다::かまける
오다, 다가오다::来るきたる
기울이다::傾けるかたむける
연주하다::奏でるかなでる
물어 끊다::かみ切るかみきる
목이 마르다, 물이 마르다::渇くかわく
싹트다, 징조가 보이다::兆すきざす
서로 다투다::きしみ合うきしみあう
상처를 입다::傷付くきずつく
마시다, 피우다, 당하다::喫するきっする
빠져 나가다, 잠수하다::くぐる
짜넣다, 편성하다::組み込むくみこむ
항상 주의하다, 명심하다::心掛けるこころがける
문지르다::さする
깨닫다::悟るさとる
습기가 차다::しける
친하게 지내다::親しむしたしむ
시들다::しなびる
칭하다::称するしょうする
살아가다, 지내다::暮らすくらす
계획하다, 꾀하다::企てるくわだてる
걸어 차다, 밟아 차다::蹴飛ばすけとばす
시도해 보다, 시험해 보다::試みるこころみる
흘리다, 불평하다, 투덜거리다::こぼす
넌더리나다, 데다::懲りるこりる
탐색하다::探るさぐる
시비를 가리다, 심판하다::裁くさばく
강요하다, 강제하다::強いるしいる
참고 견디다::しのぐ
세련되다, 멋지다::しゃれる
읇조리다, 흥얼거리다::口ずさむくちずさむ
앞당기다::繰り上げるくりあげる
연기가 나다, 부에지다::煙るけむる
거르다, 여과하다::こす
자욱하다, 가득 차다::こもる
찢어지다, 갈라지다::裂けるさける
바치다::奉るたてまつる
수여하다, 하사하다::授けるさずける
방황하다, 헤매다::さまよう
채다, 채가다::さらう
사들이다, 매입하다::仕入れるしいれる
깔다, 밑에 펴다::敷くしく
가라앉히다, 잠그다::沈めるしずめる
예의 범절을 가르치다::しつける
주저하다, 꺼리다::しぶる
떠내다, 뜨다, 물을 뜨다::すくう
움츠러지다::すくむ
씻다, 헹구다::すすぐ
미끄러지다::滑るすべる
좁히다::狭めるせばめる
우뚝 솟다, 치솟다::そびえる
물들이다, 염색하다::染めるそめる
견디다, 참다::耐えるたえる
질리다, 주춤하다::たじろぐ
거듭되다, 되풀이되다::度重なるたびかさなる
유지하다::保つたもつ
달리하다, 틀리다, 어기다::違えるちがえる
잘 다루다, 구사하다::使いこなすつかいこなす
말다, 담당하다::司るつかさどる
갚다, 보상하다, 변상하다::償うつぐなう
삼가다, 조심하다::慎むつつしむ
근무할 수 있다, 감당해 내다::勤まるつとまる
꼬드기다, 부추기다::唆すそそのかす
움츠리다::すくめる
가시다, 양치질하다::すすぐ
제지하다, 억제하다::制するせいする
파손하다, 손상하다::損なうそこなう
돈을 주다, 자아내다::そそる
물들다::染まるそまる
맡기다, 부탁하다::託すたくす
거유 다다르다::たどり着く
주시다, 내리시다::たまう
끊어지게 하다::絶やすたやす
줄다, 감소하다, 움츠러들다::縮まるちぢまる
막히다, 메다, 밀리다::つかえる
잇다, 계승하다::継ぐつぐ
덧붙이다, 첨가하다::付け加えるつけくわえる
가꾸다, 기르다, 배양하다::培うつちかう
느슨해지다, 해이해지다::たるむ
쿡쿡 찌르다::つ（つ）つく
들여다 보이다, 비쳐 보이다::透けるすける
추천하다, 천거하다::薦めるすすめる
문지르다, 갈다::擦るする
간절히 바라다::切望するせつぼうする
등지다, 어기다, 거역하다::背くそむく
꾸미다, 기교를 부리다::巧むたくむ
떠돌다, 감돌다::漂うただよう
끊다, 자르다::断つたつ
목을 매달다, 한 몸치르다::束ねるたばねる
반다, 내려주시다::賜う
알리다::告げるつげる
황공해 하다, 경의를 표하다::謹むつつしむ
버티다, 떠받치다::突っ張るつっぱる
설치하다, 비치하다::備え付けるそなえつける
드리워지다::垂れるたれる
줄다, 감소하다, 움츠러들다::縮むちぢむ
시종들다, 섬기다::仕えるつかえる
접목하다::接ぐつぐ
꼬집다::つねる
뜯다, 따다::摘むつむ
나란히 줄지어 있다, 참석하다::連なるつらなる
전환하다::転じる・転ずるてんじる・てんずる
동요하다::動じる・動ずるどうじる・どうずる
멀어지다::遠ざかるとおざかる
설득하다::説くとく
두절되다, 끊어지다::途絶えるとだえる
조정하다, 조절하다::整える・調えるととのえる
멈추다, 세우다::とどめるとどめる
격한 소리로 항의하다, 큰 소리로 따지다::どなりこむどなりこむ
뛰어오르다, 펄쩍 뛰다::跳び上がるとびあがる
어지럽게 날다::飛び交うとびかう
사방에 흩날리다, 비상하다::飛び散るとびちる
얼빠지다, 시치미를 떼다::とぼけるとぼける
헐다, 무너뜨리다::取り崩すとりくずす
혼자 도맡아 하다::取り仕切るとりしきる
골고루 갖추다, 한데 모으다::取り揃えるとりそろえる
매달리다, 착수하다::取り付くとりつく
잘 꾸리다, 수습하다::取り成すとりなす
집다, 집어 먹다::つまむつまむ
몰려들다, 밀려들다::詰めかけるつめかける
철저하다, 투철하다::徹するてっする
편승하다::投じる・投ずるとうじる・とうずる
동의하다::同じる・同ずるどうじる・どうずる
멀리하다::遠ざけるとおざける
중단되다, 도중에 끊어지다::途切れるとぎれる
구비되다, 갖추어지다::整うととのう
대들다, 덤벼들다::飛び掛かるとびかかる
크게 차이나 나다, 뛰어나다::飛び抜けるとびぬける
멈추다, 그치다::止まるとまる
환심사다, 아첨하다::取り入るとりいる
앞당겨서 하다, 앞당기다::取り越すとりこす
다잡다, 단속하다::取り締まるとりしまる
달다, 장치하다::取り付けるとりつける
한데 섞다, 뒤섞다::取り混ぜるとりまぜる
쌓다, 싣다::積むつむ
늘어놓다, 동반하다::連ねるつらねる
손수 다루다::手掛けるてがける
숭상하다, 존경하다::尊ぶ・貴ぶとうとぶ・たっとぶ
책임지다::とがめるとがめる
철하다::とじるとじる
보내어 주다, 신고하다::届けるとどける
외치다, 주장하다, 제기하다::唱えるとなえる
호통치다::どなりつけるどなりつける
뛰어다니다::飛び歩くとびあるく
뛰어넘다, 앞지르다::飛び越すとびこす
큰 차이가 나다::飛び離れるとびはなれる
억누르다, 붙잡다::取り押さえるとりおさえる
취하다, 철회하다::取り下げるとりさげる
조사하다, 문초하다::取り調べるとりしらべる
장식하다, 발탁하다::取り立てるとりたてる
멈추다, 명확히 하다::取りとめるとりとめる
떼다, 빼다, 해체하다::取り外すとりはずす
손에 쥐다, 주선하다::取り持つとりもつ
